다북쑥속의 식물	オウシュウヨモギ
습지대	しょうち
마니푸르	マニプル,マニプル州
보크사이트	鉄礬土,ボーキサイト
곡마장	競馬場
값을구함	品定め
헬리오트로프	ニオイムラサキ,ヘリオトロープ,薄紫,キダチルリソウ
종류별 분류	トリアージ
대한민국	韓國,韓国,大韓民国
검안사	眼科医
노동자	kōjin,kōfu,工人,こうふ,こうじん
바로 그렇다	きっかり
고리의	とんでもない
겁없는	大胆な
어둠침침한	暗い
겁없음	大膽,大胆
유칼리나무	1. ユーカリ 2. ユーカリ
심한 불만	混乱
필승 경기	決定戦
이온교환	イオン交換
교과서	教科書
명칭이 오용	誤称,rangnefni
검열자	レフリー
노동력	人力,じんざい,人々,人材
지나친 감상	スライム,ぬめり
나치즘	ファシズム,ナチ主義,国家社会主義,ナチズム
날씬하고 우아한	軽い
빈트후크	ウィントフック
히스티딘	ヒスチジン
검은금	石炭,黒炭
크로아티아	クロアチア
가스체의 희원소	キセノン
시계수리인	oro-rojisu-tu,時計屋
통기 통풍	曝気,給気
은자메나	ンジャメナ,エンジャメナ
보크사이드	鉄礬土,ボーキサイト
장기간에 걸친	慢性的な
아메리카 대륙	%E3%82%A2%E3%83%A1%E3%83%AA%E3%82%AB%E5%B7%9E,アメリカ州
공로장	メダル,勲章,賞牌
원생 생물	原生生物
삭제하다	消す
높이사다	過大評価する
보기싫은놈	狒々
아버지 날	父の日
표백하는 사람	漂白剤
고문단	秘密結社
골리앗	ゴリアテ
사나운 전사	バーサーカー,ベルセルク
찻주전자	ティーポット
소비자 물가지수	消費者物価指数
의지에 의한	意識的な
간헐천	間欠泉
바퀴벌레	1. ゴキブリ,甲虫類 2. ゴキブリ,油虫
노던 준주	ノーザンテリトリー
거주자	隣人,お隣
동력 삽	掘削機,ショベル
사이가 좋아지다	親友,友,shin'yū,しんゆう
건장한	賑やかな
연결하는 것	端子
상호 대명사	相互代名詞
사람의 얼굴	走行距離計,クロック,とけい,tokei,時計,置き時計
낮추다	屈辱を与える,貶める,辱める,凹ます
관람석	パビリオン
건조실	温室
연쇄상 구균	レンサ球菌
경험상의	実証的
소금절이 양배추	ザワークラウト
마데이라 흰포도주	マデイラ諸島
모터 바이크	単車,オートバイ
나체화	裸体像
겨드랑이	腋窩,脇の下,わきの下,腋下
회랑지대	回廊,回廊地帯,空中回廊,廊下
잉어과의담수어	ヨーロッパヘダイ,鯛
하품하다	1. 欠伸する 2. 欠伸する
과두정	寡頭制
사탕수수	サトウキビ
아편중독	アヘン,阿片
베들레헴	ベツレヘム
논리학자	論理学者
정상 체위	正常位
광기가 있는	すっとこどっこい (suttokodokkoi)
실업률	失業
화재 보험 회사	消防隊
정신 돌리는 약병	ヴィネグリットソース
생물과학	生命科学,ライフサイエンス
여자의 음부	まんこ,おまんこ
이라크어	イラクの
신어의	新語
아세틸렌	asechiren,アセチレン,アルキン
감탄 부호	！,感嘆符
도타운 사랑	suki
경범죄	侵害
오리온 자리	オリオン座
신약성서	新約聖書
냉장기	冷蔵庫
도로 빼내다	開く
냉장고	1. フリーザー 2. 冷蔵庫 3. 冷蔵庫
통계학	統計学,統計
실업가	実業家
요염한 여자	妖婦,妖女,ファム・ファタル
몰리브데넘	モリブデン
기독교계	キリスト教
토끼굴	地下道
기독교국	キリスト教
그림엽서	葉書,hagaki,はがき
의료의 신	アスクレーピオス
끓이는 그릇	ボイラー
은유적인	比喩,比喩的な
음악학교	音楽学部
말채나무	ミズキ,ミズキ属
경보기	警報
네바다	ネバダ
기독교도	1. キリスト教徒,クリスチャン 2. キリスト教徒,クリスチャン 3. キリスト教徒,クリスチャン
물리학자	パスカル
파이살라바드	ファイサラーバード
스위스 북부의 주	チューリッヒ
보낼 곳	目的地
전기 분해	電解,電気分解
과민증의	アレルギー性の
광대뼈	頬骨
생물군계	生物群系
유령 도시	ゴーストタウン
부 명제	補題
신경전달물질	神経伝達物質
시인의	詩人の,詩的な
수하하는 사람	挑戦者
오럴 섹스	口内性交,shakuhachi,オーラルセックス
산재하는	散発的
상호작용	対応
나침반	方位磁針
고령토	カオリナイト
수평적 통합	水平統合
필적하다	競争する,争う,張り合う
세계 열강	スーパーパワー
인종 혼합의	交じった,混合した
곤란한	大事な,難しい
시끈가오리	魚雷
괴깔의	ふかふかした,ほっこり
스칼렛	くれない,朱,あか,緋色,丹朱
티그리스강	チグリス川
카시오페이아자리	カシオペア座
스칸듐	スカンジウム
토끼풀	クローバー
쉬하다	小便をする,おしっこをする
종교적인	1. seinaru 2. 敬虔,宗教にかこつけた,信心深い,敬虔な
논다니	売春婦,娼婦,パンスケ,ばいしゅん,させ子,売女,街娼
투명 도안	透明性
아드보카트	アドヴォカート
종교재판	異端審問
고릴라	ゴリラ
게시판	掲示板
사로잡힘	妄想
가림없는 물건	裸体像
시장 가격	実勢価格,相場
입체 음향의	ステレオ
직역주의	写実主義
실어증	失語症
검약가	エコノミスト,経済学者
일부 일처의	一夫一婦
국외 의존의	戦略的な
네모꼴	長方形,ちょうほうけい
공명히	正直に
돌발적인	散発的
국경일	国民の祝日,祭日,建国記念日,祝日,休日,祝祭日
과도하게	1. 無理に,あまりに 2. 過ぎ,過剰に,あまりに
고속차 전용 도로	高速道路
그리스도	イエス・キリスト,みこ,イエスキリスト,キリスト
시죄법	神明裁判
리우데자네이루	リオデジャネイロ市,リオデジャネイロ
일부 일처제	一夫一婦制
공민권	人民,市民,国民,公民,民衆,臣民,民
관모구	たんぽぽ
아밀라제	アミラーゼ,amirāze
텍사스	テキサス,テキサス州
선례가 없는	未曾有
아메리칸사모아	アメリカン・サモア,アメリカ領サモア
정확한 중심	真中
식중독	食中毒
비례하여	比較的,比較的に
스컹크	スカンク
몰샐 틈 없는	気密,密閉
공부벌레	ひとりよがりの
기니아픽	アグーチ
오르가슴	ōgazumu,オルガスム,オーガズム,オルガスムス
그릇읽다	勘違い,誤解
실제로	実は,実際には
경식당	茶室,喫茶店
탄탈룸	タンタル
상대주의의	相対論的
심연의	極端な
시적인	詩人の,詩的な
작전 연구	オペレーションズ・リサーチ
노래하는 사람	歌手
올림피아 경기	オリンピック,近代オリンピック,オリンピック競技大会
~의 목을 베다	打ち首にする
공배수	最小公倍数
폴터가이스트	ポルターガイスト現象
우주생물학	宇宙生物学
3박자의 느린 춤	メヌエット
낙천가	rakuten,らくてん,楽天
심장병	心臓病,循環器疾患
운전 면허증	運転免許証,運転免許
심전도	心電図,しんでんず
거처방	茶の間,ima,居間,いま,リビング
항아리 손님	流行性耳下腺炎,おたふく風邪
중화인민공화국	中華人民共和国,中国
거인 같은	巨大な,きょだいな,kyodaina
녹내장	緑内障
후허하오터	フフホト
싸우다	戦う
판첸라마	パンチェン・ラマ
카사블랑카	カサブランカ
십이월	師走,じゅうにがつ,十二月,12月
십일월	十一月,１１月,じゅういちがつ,霜月,11月
스탈린	スターリン
손가락관절	指関節
투명 무늬	透明性
무력 정변	乗っ取り,謀叛
유채과의 야채	クレソン,コショウソウ
민간전승	でんせつ
공산주의적인	共産
동시에 일어나다	一致する
과묵한	寡黙,無口
스키술	スキー
십자가	十字架像
구급차	救急車
시대 착오	時代錯誤の
실제상	1. 有効に 2. 有効に
신조어	1. 新語 2. 新造語,新語,造語
녹나무	クスノキ
그리스어	1. ギリシア人,ギリシア語,ギリシャ人 2. ギリシア語
사용하기 거북한	不器用な,ぎごちない
스코페	スコピエ
승낙하다	同意する
공복의	お腹の空いていた,空腹な,飢えた
여정기록	日誌,自動車登録台帳
펄형 활자	梨,梨の実
십자말	クロスワードパズル
건초밭	草原
남작들	かぞく
충양돌기절제술	盲腸炎手術
투르크멘어	トルクメン語
간호원	看護士
먹어치우다	破壊する
요령 없는	頭が悪い
군중 공포증	広場恐怖症
견습공	実習生
스타킹	ストッキング
실지의	実用的,経験豊かな,実際的,実践的,実務経験のある,実践的な
장님거미	ザトウムシ,盲蜘蛛,足長おじさん,座頭虫
실직안	失業者,しつぎょうしゃ
신병모집	chōshū,ちょうしゅう,徴集
세포소기관	細胞小器官
강하게	必ず,確かに,きっと
게우다	1. 嘔吐する,嘔吐,吐く 2. 吐く
박트리아 낙타	フタコブラクダ
거짓말	1. お伽話,おとぎ話,メルヘン,童話 2. 嘘,きょげん,虚言,うそ 3. 無意味
캔자스시티	1. カンザスシティ 2. カンザスシティ
건조한	喉が乾いた
스토브	1. ストーブ 2. ストーブ 3. レンジ,オーブン,ストーブ 4. 焜炉,コンロ,ストーブ
실질상	中々,実質的に,なかなか
나중에	それ,それから,その後,後で
스타일	すい
탈취제	デオドラント
겁쟁이	腰抜け,臆病者
템버린	タンブリン,タンバリン
눈에 보이게 함	映像化,可視化
레이스용 요트	ボート,船,ゆうらんせん,ヨット
반대심문	反対尋問
고발의	批難,非難
공리설	功利主義,実利主義
난쟁이	1. ピグミー 2. ドワーフ
계산기	計算者,計算表,計算機,電卓,dentaku,コンピュータ
봉건 제도	封建制度,封建制
은행나무	銀杏,公孫樹
고깃국물	グレービー
일년 내내	いつも
곧바로	すぐ,直接,すぐに,たちまち,直ちに,+ に +ni,直ぐに
부유 생물	プランクトン,浮遊生物
신중히	じっくり,丹念に
심장학	心臓学,心臓病学,循環器学
신중한	慎重
매매각서	忘備録,メモ
계산된	作為的な,意識的な
경상체	光学異性体
남정석	藍晶石
부검검시	検死
일회 분량	水薬
形容詞	けいようし,形容動詞,形容詞,keiyōshi
이교도의 신앙	ペイガニズム
게자리	かに座
남조선	韓國,韓国,大韓民国
탄탈럼	タンタル
루손섬	ルソン島
농구공	バスケ,バスケットボール
파키스탄의	パキスタンの
윤곽이 뚜렷한	ビクビク
민족적 우월감	人種差別
위안을 주는	こころづよい,心強い
스패너	スパナ,レンチ
산사나무	サンザシ
공교롭게도	ainiku,残念,生憎
그레이하운드	グレーハウンド
남자의	男性名詞,男性,男性的な,男の,男性の
계산일	聖名祝日
턱시도	タキシード
국가의	政治上の,政治的な
게이샤	芸者,芸妓,芸子
우연히도	ふと,無意識的に
달마티아 개	ダルメシアン
벌칙을 적용하다	懲罰する,ばっする,制裁する
백만장자	1. だいふごう,大富豪,ひゃくまんちょうじゃ,百万長者 2. だいふごう,大富豪,ひゃくまんちょうじゃ,百万長者
단궤철도	モノレール
경쾌한 춤	タランテラ
실직한	失業者
고분자	高分子
운수 나쁘게	ainiku,残念,生憎
관리인	保護者,係員
입을 꼭 다문	口堅い,口が堅い
관리자	学芸員
폭소하다	叫ぶ
음절 문자	音節文字
괴로운	痛い,いたい,苦しい
고수풀	コリアンダー
남학생	しょうがくせい,小学生
견주자	subesube,すべすべ
결정학	結晶学
트랜스폰더	トランスポンダ
히말라야	ヒマラヤ
타악기	だがっき,打楽器,dagakki,パーカッション
결정자	限定詞
표를만들다	計画,議事,日程
신에게 버림받은	砂漠
벌레구멍	ワームホール
미혹케 하는	欺瞞的な
냄새나는	くさい,臭い
민족청소	民族清掃,民族浄化
신참자	初心者
곱사등	傴僂
마누라	家内,fujin,妻,女子,つま,okusan,奥さん
감실에 모시다	聖骨箱
실체경	実体鏡
스페인	スペイン,Supein,supein,西班牙
나팔수선화	ラッパズイセン
견적인	計算機
믿기쉬운	あどけない
입국관리	nyūshoku,いにゅう,にゅうしょく,入植,イミグレーション,移民
걸치어	1. にまたがって,足を広げて 2. 足を広げて
경영자	所有者,経営者,持ち主
철회할수 없는	不可逆な
디젤 엔진	ディーゼル燃料,軽油,ディーゼルエンジン,ディーゼル
노벨륨	ノーベリウム
십이지장충	こうちゅう
시청사	市役所
보온카버	コゼー
계엄령	戒厳令
지치게 하는	退屈な
실체론	オントロジー,存在論
경쟁자	挑戦者
침 치료	鍼治,鍼,鍼治療,鍼術,漢方
밀통;창녀	淫売,売春,baishun,買春,切り売り主義
의문부호	疑問符,？
공상의	人工的な,人工の,人為的な
은거하는 곳	ていねんたいしょく
권위있는	権威のある
수니파 교도	スンニ派,スンナ派,スンニ,スンニー派
오스트리아	墺太利,オーストリー,オーストリア
종묘원 주인	庭師
구더기	ウジ
캐스터네츠	カスタネット,シンバル
볼고그라드	ヴォルゴグラード
경작지	エーカー
근대 그리스러	現代ギリシア語
담의 재료	けんじゅつ
시카고	シカゴ
시골사람	農家
고시판	掲示板
10년간	十年
마나마	マナーマ
앨버트공	アルベルト,アルバート
소택이 많은	浸水した
콜라 반도	コラ半島
화이트 하우스	ホワイトハウス
계속적으로	絶え間なく,いつも
미국 영어	米英語,アメリカ英語,米語
말레이 사람	マレーシア人,マレー語
정밀검사	調査,点検
두목 행세하는	うるさい
12각형	十二角形
탐색자	実験者
해석가능성	溶解性
논리성	論理学
샤르트르	シャルトル
훌륭하게	心地よく
슬퍼할	悲しい
주정 수준기	精神レベル
키우다	飼う,食べさせる
주교 관구	教区
성장 호르몬	成長ホルモン
거취조	ムネオオハシ
큰천막	パビリオン
동시에 하게 하다	同調
고산병	高山病
퇴화 기관	なごり,痕跡,足跡
신축성	だんせい,弾性,柔軟性,弾力性
광막한	莫大な,dekai,dekkai,莫大,でかい,広大,でっかい,広大な,大きい,巨大
11각형	十一角形
고생대	古生代
예의 범절	順当,正則
신칸센	新幹線
막대한	莫大な,dekai,dekkai,莫大,でかい,広大,でっかい,広大な,大きい,巨大
공부자	孔子,fūshi,孔夫子,夫子,ふうし
승도복숭아	ネクタリン
낯을 붉히어	恥じている,恥ずかしい
창조적임	創造性,創造力
건초열	花粉症
오스만 터키어	オスマン語
딱딱하고 거북한	mushiatsui,蒸し暑い,むしあつい
거칠게	ぐらい,先ず,およそ,約
맹금류	もうちょう,猛禽
새끼 손가락	こゆび,小指
부비강염	副鼻腔炎
키예프	キエフ
낙하산	落下傘
강산화성 물질	オキシダント,酸化剤
과민한	アレルギー性の
서사모아의 수도	アピア
공부방	kyōshitsu,きょうしつ,教室
민족지학	民族誌
검찰관	検察,検察官
신경단위	ニューロン,神経細胞
일본 옷	和服,きもの,着物
벌을 주다	懲罰する,ばっする,制裁する
강박 관념	妄想
12궁도	黄道帯
바가지 긁는 여자	カタマラン
광물학	鉱物学
자기 디스크	ディスク
거듭되는 불행	イリアス
세일즈맨	店員
고소인	原告
고소의	批難,非難
죄에 해당하는	有罪い
태산목	モクレン
걸출한	顕著
구름같은	くもり,(kumori)
국내법	大陸法,民法
중추 신경계	中枢神経系
분음기호	分音符号
테니스	テニス
견인차	トラクター
경합하다	競争する,争う,張り合う
논리학	1. 論理学 2. 論理学 3. 論理学 4. 論理学 5. 論理学
논리합	1. 論理和 2. 論理和
낭패의	恐怖
설명 자막	字幕
권계면	対流圏界面
참주정치	スターリニズム,独裁政治,幕府,bakufu,独裁
교도소	1. 拘置所,監禁所 2. けいむしょ,ペナルティーキック,かんごく,刑務所,監獄,ダンジョン 3. けいむしょ,かんごく,刑務所,監獄
티그리스 강	チグリス川
예의 바름	順当,正則
살쾡이의 일종	サーバル
유비쿼터스	ユビキタス
계수형인	デジタル
네온등	ネオン
포스터모더니즘	ポストモダン
버스 터미널	バスステーション
아지랑이	蒸気,湯気,気体
요르단 왕국	ヨルダン川,ヨルダン
말수적음	無口
시코쿠	四国
마닐라	マニラ
명상적인	反射的な
만년필	1. 万年筆 2. ボールペン 3. 羽根ペン
템스 강	テムズ,テムズ川
맛나는	美味しい,おいしい
계집애	少女,女の子
프라세오디뮴	プラセオジム
소나타 형식	ソナタ形式
시키다	笑う,笑い飛ばす,一笑に付す
쓸데없는 참견	実用主義
생물발광	生物発光,生物ルミネセンス
놀랍게	すごく
어김없는	必至の,恒常的,避けがたい,常習,避けることのできない,必至,不可避
테레빈	テレビン油
뼈빠지게하다	働く
국가 해상 보안대	沿岸警備隊
고용인	従業員,雇員,使用人,勤務員
시타르	シタール
동종요법	ホメオパシー
부정관사	不定冠詞
흰 모자	トランペット,口琴
태양왕	太陽王
관계대명사	関係代名詞
고인돌	支石墓
치과의사	歯医者,歯科医
말고기	馬肉
괴이쩍은	ayashii,怪しい,怪しむような,疑いの,あやしい
털모자	シャコー帽
노련자	古兵
태양풍	太陽風
육욕을 자극하는	官能的な,肉感的な,豊満な
도플갱어	ドッペルゲンガー
포름알데히드	ホルムアルデヒド
건포도	乾葡萄,干葡萄
놀라운	igai na,いがいな,意外な
놀라움	1. 驚き 2. 驚き
나폴리	ナポリ県,ナポリ
경찰력	警察
상트 페테르부르크	サンクトペテルブルク
내국세 수입	情報検索
산림 관리	林業
빨 수 있는	洗濯できる
접두사를 붙이다	接頭辞
노력한	専門的な
투르크메니스탄	トルクメニスタン
마가린	マーガリン
국립 고등 학교	中学校
탐조등	サーチライト,sāchiraito
귀고리	イヤリング
마가목	ナナカマド
무자맥질하다	飛び込む,潜る
백년마다의	世俗の,世俗,非宗教的な,非宗教的,世俗的な
경찰서	警察署
이산화탄소	二酸化炭素
소형 저울	トレビュシェット
고가 철도	エル
여우원숭이	キツネザル
테르븀	テルビウム
골연증	骨粗鬆症
부분집합	部分集合
거품은	泡,あわ,あぶく
고유성	固有種
절대온도의	絶対,絶対な
유년 시대	子供時代
고의로	故意,故意に,わざと,意識的な,態と
경찰관	警察
숙청하다	大掃除する
12개월	太陽年,年
텔루륨	テルル
텔루르	テルル
샐러드의 일종	シーザーサラダ
신용할수 없는	驚異的な,インクレジブル,ありえない,飛躍しすぎている,信じられない
고유종	固有種
느릅나무	楡,ニレ
고의의	作為的な,意識的な
고유치	固有値
우쿨렐레	ウクレレ
노른자	卵黄
찌꺼기	廃棄物,廃物,ゴミ
경찰대	警察
부젓가락	火箸,パンばさみ
농담의	茶目な
군대의	軍事的な
시트론	1. シトロン 2. シトロン
공수병	狂犬病
경제학	経済学
구덩이	掘削,開削
개별적인	慎重
냉난방장치	クーラー,空調装置,エアコン,空調,冷房装置,空気調節,空気調和,家電製品,冷房
구도자	作曲者,sakkyokuka,さっきょくか,作曲家,さっきょくしゃ,sakkyokusha
호랑가시나무	セイヨウヒイラギ,モチノキ
평화적인	1. 平安な,安静な,平和な 2. 親切な
타자기	タイプライター,印字機
포복 절도하다	叫ぶ
악취가나는	くさい,臭い
살균하십시요	殺菌する
사후 강직	死後硬直
까렐리야	カレリア
사전편집	辞書編集,辞書学
부수적으로	ところで,ちなみに
공세의	積極的
탄원서	嘆願
얻어내다	誑す,丸め込む,強請る
북대서양의 군도	アゾレス諸島
기를 씀	必死
세인트피터즈버그	ペトログラード,サンクトペテルブルク,レニングラード,セントピーターズバーグ
타이어	1. タイヤ 2. タイヤ
베타입자	ベータ粒子,β粒子
타이완	中華民国,中國,台湾
동면하다	冬眠
분해한 상태	bunkai,分解
화재 경보	火災警報,火災警報機
룩셈부르크어	ルクセンブルク語
헤시오도스	ヘシオドス
일부 다처	一夫多妻
관세표	関税
비교적으로	比較的,比較的に
삶은 달걀 컵	卵立て,茹で玉子入れ,茹で卵立て
소아시아	しょうアジア,小アジア
리놀륨	リノリウム
마슈하드	マシュハド
타이중	台中
스페인어	スペイン語
메밀가루	蕎麦,ソバ
돈벌이가 되는것	金鉱
소형 어선	漁船
마그마	マグマ
미지근한	1. 中途半端な,気が進まない,冷めた,ぬるい,生暖かい,白けた 2. 冷めた,ぬるい,なまぬるい
우성 유전자	優性遺伝子
민족정신	きっぷ
등록하다	登録する
실질이 없는 물건	蒸気,湯気,気体
고양이	子猫
방수 외부	タープ
나트륨	ナトリウム
평온하게	静かに,安静に
태양년	太陽年
동시 발생	共時性
과거를 그리워함	かいきゅう,懐旧,郷愁,望郷,ノスタルジア,里心
제 3의	3次的な,3番目の
제 3자	外人,外国人
의식이 있는	知覚する,意識した,意識する,眠らずに
태양계	太陽系,taiyōkei
고안력	巧妙
구두점	句読点
리눅스	Linux,リナックス
엄청나게	凄く
태양력	太陽暦
천연자원	資源,自然資源,天然資源
구두의	口頭
고아원	孤児院
탄저열	炭疽症
말치레가 번드르한	ごますりの
할아버지	外祖父,祖父,そふ,お爺さん,おじいさん,sofu
덩굴월귤	クランベリー
최초의전도자	shito
공시상	共時性
노력가	働き者
털많은	毛深い
고압선	電線,電気コード
노래방	カラオケ
나팔꽃	朝立ち,朝顔
곱슬털	hen
유클리드 기하학	ユークリッド幾何学
전자공학	電子工学,でんき
경청하는	注意深い
호되게 해치우다	懲罰する,ばっする,制裁する
낭비가	使い手,浪費家,ろうひか,つかいて
마르다	わずかな
경청하다	聞く
극단적으로	無理に
개신교	プロテスタント
말라위	マラウィ,マラウイ
골든 게이트 브리지	ゴールデンゲートブリッジ
양모 중매인	ホッチキス
집약적 경영	含意
실독증	ディスレクシア,失読症
프랑크말	共通語,リングワ・フランカ,リンガフランカ
벨로루시아어	1. ベラルーシ語 2. ベラルーシ人,ベラルーシ語
다람쥐의 일종	シマリス
거래장	通帳
자포자기하여	緊急に
버킷 하나 가득	バケツ
말라야	マレーシア,Marēshia
어버이의	母方の,母性,父方の,父性
어버이임	母方の,母性,父方の,父性
파도 많은	ウエーブのかかった,くねくねした
홈그라운드	生息地,棲息地
오렌지의	オレンジ色
대립형질	対立遺伝子,アレル
시드니	Shidonī,シドニー
가연성	可燃性
슬리퍼	スリッパ
나무 벽돌	木版画
앞쪽의 방	茶の間,ima,居間,いま,リビング
쇠귀나무속의 식물	矢じり,慈姑
마라톤	1. マラソン 2. マラソン
표면 장력	表面張力
리무진	リムジン
비평하다	批評する
사방 육면체	菱形,斜方形
~을  할만하다	値する
카리스마적 권위	教祖的指導力
참기름	ごま油
부동산관리인	不動産屋
콘스탄티누스 대제	コンスタンティノス
톈진 시	天津,天津市
큰인기	政変
전자기학	1. 電磁気学 2. 電磁気学
램프의 갓	ランプシェード
마리아	マリア,メアリー,マリー
전자기파	denjiha,電磁波,でんじは
끝없이	幾久しく,eikyūni,ikuhisashiku,永久,永久に,永遠
리버풀	リバプール
강수량	雨,降水,降水量
갈라디아 서	ガラテヤ人への手紙
자연의 힘으로	勿論,もちろん,当然
긁어부스럼	ブーメラン
도깨비시장	市場,蚤の市,古物市,フリーマーケット
힌두교의 도사	グル,教祖
리볼버	リボルバー,六連発
날개형부대	浮き輪
심박급진	頻脈
교원 휴게실	居間,リビング
감시인	所長,看守
전자기의	電磁,電磁気の
경기병	ユサール
코카서스	カフカース
슬로바키아어	1. スロバキア語,スロヴァキア語 2. スロヴァキア語
진핵생물	真核生物
계관식	鶏冠石
스모그	煙霧,スモッグ
채가다	誘拐する
맹도견	盲導犬
외바퀴 자전거	一輪車
두뇌집단	シンクタンク
작은 꽃다발	ブーケ
3목 놓기	三目並べ
결정적 단계	境目,不景気
관념 형태	イデオロギー
타밀어	タミル語,タミール語
기적적인	驚くべき,素晴しい
말많은	おしゃべり好きな
강생이	子犬
경구개	硬口蓋
리비아	リビア
개새끼	くそったれ
이심전심현상	いしんでんしん,テレパシー
자명종 소리	警報
기다리다	まつ,予想する,望む,期待する,待つ,予期する
신경성 식욕 부진	神経性無食欲症
일어나다	起きる
꼼꼼하게	心地よく
속기 쉬운 사람	犠牲,生け贄
무역상인	商人,shōnin,しょうにん
타박상	打撲傷
동중국해	東シナ海
프러시아	プロイセン
영양에 관한	栄養素
잘 주무세요	おやすみなさい
절대필요성	一切
큰 굴뚝	煙突
검둥이	ニガー,黒いやつ
라트비아어	ラトビア語
귀찮은 사람	雀蜂,スズメバチ,モンスズメバチ
리비도	性衝動,リビドー
내몽고	内モンゴル,内蒙古
감식가	目利き,鑑識家,鑑定家
공보활동	パブリック・リレーションズ,PR,ピー・アール
적요하다	短縮する,縮む,略す,省略する
네덜란드령 안틸레스	オランダ領アンティル
가철한 책	小冊子
수출품	ゆしゅつ,輸出品,輸出,yushutsu
공중 변소	かわや,手洗い,べんじょ,厠,便所,休憩所,化粧室,憚り,トイレ
전기 공학	電気工学
쉐이쉘	1. セイシェル 2. セーシェル,セイシェル
작업능률연구	人間工学,エルゴノミクス
스코틀랜드 사람	スコットランド人
코삭 사람	コサック
쌍날의 큰 칼	クレイモア
전기 기타	エレキギター,エレクトリックギター
결과의	結果と
의심스러운	1. 疑わしい 2. 疑わしい
가슴뼈	胸骨
손씻는 예식	洗面器
금속 원소의 하나	パラジウム
헤모글로빈	ヘモグロビン,血液色素,血色素
르완다	ルワンダ
그 해만의	毎年,毎年の
플란데런	フランドル,フランダース,フランデレン地域,フランドル・フランセーズ,フランデレン州
졸며시간을 보내다	居眠り,いねむり
복지 국가	福祉国家
호리병박	瓢箪
감속도	減速
암모니아	anmonia
사라토프	サラトフ
게다가	その上,しかも,その上に,尚且つ,さらに,katsu
그만두다	終える,終了する
신디어	シンディー語
연쇄 반응	連鎖反応
육식 공룡의 하나	ティラノサウルス
갑상선	甲状腺機能低下症
간수장	所長,看守
공중 부양	空中浮遊,空中浮揚
순찰차	パトロールカー,パトカー
견갑골의	肩胛骨,肩甲骨
포클랜드 군도	フォークランド諸島
그린란드	グリーンランド
결국은	やっと,ついに,結局,最終的に,とうとう
세제곱근	立方根
세계 대전	1. 世界大戦 2. 第１次世界大戦,第一次世界大戦
정찰활동	偵察,ボーイスカウト
수척한	やつれた
때묻히다	脂肪
키부츠	キブツ
아주 맞았어	絶対に
스펙트럼	分光特性,スペクトル
이리가 된 사람	狼男
암호로 바꾸다	暗号化する
그레이프프루츠	グレープフルーツ
말다툼	ナラタケ
테네시	テネシー,テネシー州
상상할 수 없는	問題外,信じられない,問題にならない
노동 인구	人力,じんざい,人々,人材
고귀한	正直な
여기서 부터	従って,ですから
케이프타운	ケープタウン
저항 장치	抵抗器
시체애호가	死体愛好症
직4각형	長方形,ちょうほうけい
이기주의	自惚,己惚
책꽃이	本棚
쉬운일	asameshimae,朝飯前
한 지방	田舎,田園
매년의	毎年,毎年の
공간의	空間的
믿기어려운	不可能
그리수도 수난상	十字架像
활용하다	上達する,上達させる,改善,良くなる,改善する
거미줄	くもの巣,蜘蛛の巣,クモの網
파충류학	爬虫両棲類学,爬虫類学
가지색	なす,茄子,nasubi,nasu,ナス,なすび
불가결성	一切
갈증난	喉が乾いた
강자성	強磁性
감정업	目利き,鑑識家,鑑定家
자본주의	資本主義
탬버린	タンブリン,タンバリン
강인성	忍耐,堅持
겁먹은	パニック状態
글로벌화	グローバライゼーション,グローバリゼーション,グローバル化
트롬본 취주자	トロンボーン
우연적인	偶然的な
거부권	拒否権
참나무	1. かしわ,柏,オーク 2. オーク材
룩셈부르크	1. ルクセンブルグ,ルクセンブルク 2. ルクセンブルグ,ルクセンブルク
탄산수	ミネラルウォーター
남부 독일의 지방	ザクセン
유약칠하는 직공	ガラス工
재수 좋은 사람	運のよい,幸運,運の良い,ラッキー
굴 파기	掘削,開削
동맹 파업	ストライキ
인간 생태학	人口学,人口統計学
익살맞은	剽軽,hyōkin）
소근거림	こごえ,私語,小声
구과 식물	針葉樹
이기적인	自分本位の,利己的な,わがままな,身勝手な,勝手な
기생충 감염증	寄生生物
부조리한	不調和な
세레나데	1. セレナーデ 2. セレナーデ
간접의	中古
식충동물	食虫動物
그루지야	グルジア,ジョージア
루테늄	ルテニウム,ルウニウム
거꾸로 할 수없는	不可逆な
전임강사	教師
압제적인	独裁的な
여자친구	姉妹
가죽신	サンダル,草鞋
실뜨기	あやとり
자리에 앉히다	実装する,導入,インストール,インストールする,導入する
매너티	マナティー,マナティ
갑자기	突如,急に,突然,突然に
찻숫가락으로 하나	ティースプーン,小さじ
강우량	雨,降水,降水量
고은 무명	タミル・ナードゥ州,タミル・ナードゥ
넓적다리	腿,股,太股
땋은 머리	hen
서양 담쟁이 덩굴	kizuta,蔦,ツタ,キヅタ
불평을 말하다	叱る,しかる
간종양	かんがん
차주채무자	借方,債務者
참깨씨	胡麻,ゴマ
실리카	ケイ素二酸化物
매달의	月次,毎月
라이브러리	1. 図書館,ライブラリ 2. 図書館
실리콘	ケイ素,珪素,シリコン
큰짐승	巨人
yeoji	茘枝,レイシ,ライチ
1학기	四半期
소수 독재 정치	寡頭制
거머리	寄生生物
루테튬	ルテチウム
강어귀	河口,川口
음의 합성 장치	シンセサイザー,音源
감염병	感染病
냉동실	冷蔵庫
앵무조개	オウムガイ
소수의 독재자	寡頭制
겉꾸밈의	表面上
강약법	原動力,動力学
고공병	高山病
가정법	仮定法,接続法
접촉작용	触媒作用
가정부	女中,メイド
거만한	傲慢な,横柄な,高慢な
확인하다	1. 発見する,発見 2. 確かめる 3. 確かめる
냉동고	フリーザー
태백성	宵の明星
냉동기	フリーザー
강아지	子犬
큰개자리	おおいぬ座
진흙투성이의	浸水した
책갈피	ブックマーク,栞
검류계	検流計
자선을 베푸는	奇特な,奇特
자이로 플레인	ヘリコプター
돌연 변이체	突然変異体,突然変異
건망증	記憶喪失
병신을 만들다	ばらばらにする,ばらばら
가장한	表面上
컨테이너	いれもの,iremono,入物,入れ物,コンテナ,容器
혈관 조영법	血管造影
고구마	サツマイモ,芋
판첸 라마	パンチェン・ラマ
시멘틱	セマンティック
판 구조론	プレートテクトニクス
세상 이야기	話々,世間話
회상하다	覚える,思い出す
실로폰	マリンバ,シロフォン,木琴
로드아일랜드	1. ロードアイランド 2. ロードアイランド
프랑스 공화국	フランス
온라인의	オンライン
미국동부의 주	デラウェア州
고가교	ガード,高架橋
말라기	マラキ書
가외의	過剰な
법정휴일	国民の祝日,祭日,建国記念日,祝日,休日,祝祭日
찰나의	はかない,hakanai,儚い,儚い (はかない)
신명기	申命記
흡혈박쥐	吸血鬼,ヴァンパイア,ラミアー
나룻배	フェリー
비스바덴	ヴィースバーデン
터놓고	正直に
채권자	貸方,債権者
비스무트	ビスマス
가우초	ガウチョ
채굴지	掘削,開削
상공회의소	商工会議所
쌍동선	カタマラン
비밀을 누설하다	言う,あばく,abaku,暴く
다오메이	ベナン共和国,ベナン,ベニン
맥동성	パルサー
시리아	シリア
고리 갑옷	鎖帷子
부득이한	必至の,恒常的,避けがたい,常習,避けることのできない,必至,不可避
최종적 해결	ユダヤ人大虐殺,ホロコースト
일견하여	一目で,一目見ただけで,一見,一目,一見し
건선거	乾ドック
계승하다	継承する,受継ぐ
초현실주의의	超現実的
석판인쇄술	石版刷り,リトグラフ
유지하다	節約する
조직을 세우다	体系
격리자	誘電体
맑은 수프	コンソメ
전군 최고사령관	総統
고대의	古代
옛날의 소아시아	しょうアジア,小アジア
자백하다	公言する
실바람	強風
상호관계	相関
여객 수송용 소형	リムジン
맛 좋은	旨い,あまい,oishii,おいしそう,おいしい,風味のよい
해면동물	海綿動物
광고업	CM,広告
일정하지 않은	不定な
안티모니	アンチモン,アンチモニー
윤기 있는	subesube,すべすべ
곤줄박이	アオガラ
수하물	荷物,手荷物,スーツケース,かばん,鞄
너무나	無理に,あまりに
표백업자	漂白剤
열이나다	1. 熱 2. 熱
전사술전사화	デカルコマニー
상병자 운반차	救急車
동 시대 사람	じんるい,人類,jinrui,人間
머그워트	1. ヨモギ 2. オウシュウヨモギ
갠지스	ガンジス,ガンジス川
마사지	マッサージ
참석하다	出席する
횡경막염	脳炎
마상이	カヌー
불법행의	違法,違法性
악마 신앙가	サタニズム
기생 동물	寄生生物
나이트	騎士
신문발행인 협회	通信社
중부 아프리카	中部アフリカ,中央アフリカ共和国
광견병	狂犬病
스릴을 주는 것	スリラー
공동 생활	共生
리야드	リヤド
리모트 콘트롤	遠隔操作,リモートコントロール
신문의	段落
망설이게	いじいじ
나일강	ナイル川
맥주같은	biiru,ビール,麦酒,bīru,ビール1杯
산소결핍	窒息
106번 원소	シーボーギウム
반대하여	嫌って
지명사전	地名辞典
고문 전문의	顧問
신문업	報道,ジャーナリズム
수평면	水位
도버해협	ドーバー
혹평하다	批評する
망설이다	躊躇する,ためらう
의지상실	意志欠乏
부자주의	父方の,父性
탈당자	背信者
스스로	自ら,直々に
나우루	1. ナウル 2. ナウル
망자를 위한 미사	死者のためのミサ,鎮魂歌
代名詞	代名詞
육상 하키	ホッケー
앞서 말한	前述の
겨루다	競争する,争う,張り合う
메노라	メノーラー
마술사	魔人,まじん,majin,ウィザード,魔法使い,魔術師
심리학	形而上学
수평의	横の,横,水平な,水平
탄도학	弾道学
시보귬	シーボーギウム
가치있는것	資産
오스트랄라시아	オーストララシア
정신적인 지도자	グル,教祖
수평선	横の,横,水平な,水平
식물학	植物学
군사정부	軍事政権
만성의	慢性的な
립스틱	口紅,リップスティック
서양 쌍륙	バックギャモン
악착같은 야심가	出来星,成り上がり者,成り金
큰소리를 지르다	叫ぶ
배글 빵	ベーゲル
원자 병기	核兵器
신빙성	信用性,真実性
타갈로그어	タガログ語
터치 스크린	タッチパネル
농업을 맡은반인	ファウヌス
공기총	空気銃
쓸데없이	1. 不用に 2. 不用に
타밀나두 주	タミル・ナードゥ州,タミル・ナードゥ
영양물의	栄養素
야심의 대상	野心,抱負,アンビション
점액질의	粘液質の
큰 곰자리	おおぐま座
블라디보스토크	ウラジオストク
반어적인	皮肉な,風刺的な
수호자	保護者,係員
마시다	飲む
매우 가까운사람	いとこ,従兄弟,従姉妹
마술의	マジック
리액터	原子炉,反応器
심벌즈	シンバル
주1회	毎週
츠와나어	ツワナ語
길이 저문	遅い
소리를 내지 않고	1. sotto 2. sotto
타동사	他動詞
세쿼이어	セコイア
넘치도록	多量に
신비한	不思議,神秘的
낙엽송	カラマツ
야릇하다	ぶきみな
맞서다	競争する,争う,張り合う
사슬 갑옷	鎖帷子
화용론]]	語用論
퍼뜨리다	種をまく
심부름	用事,shimei,使命,しめい
성전승인	列福
木曜日	mokuyōbi,木曜日
교환하다	1. 取り換える 2. 替える
원자핵 파괴 장치	粒子加速器,加速器
맥주거품	カリフラワー
관광단	観光
성가ㅈ신 사람	雀蜂,スズメバチ,モンスズメバチ
거북이	亀,カメ,かめ,陸亀
이데올로기	1. イデオロギー 2. イデオロギー
조직하다	1. 組織する 2. 組織する 3. 組織する 4. 組織する 5. 組織する
개미핥기	センザンコウ
관광객	旅行者,ツーリスト,観光客
뒤에 남는 영향	後遺症,余波
수행자	検察,検察官
멸균자	オートクレーブ
개자식	くそったれ
교활하다	巧妙な,狡い,ずるい,狡猾,悪賢い
그 위에 더	その上,しかも,その上に,尚且つ,さらに,katsu
큰바람	強風
대상 포진	帯状疱疹
공고판	掲示板
푸른 나무	緑,みどり,midori
마르티니크	マルティニーク,マルティニーク島
매사냥	鷹狩り
죽 음	1. 死 2. 死 3. 死ぬ,死 4. 殺人 5. 死 6. 死 7. 永逝,死 8. 死
쓸데없는	むなしい
순환계	循環器
수화물	水和物
큐레이터	学芸員
과격론	ボリシェヴィキ
새 풍토 순화	順応,適応
큰박쥐	オオコウモリ
건방진	傲慢な,横柄な,高慢な
공격의	攻撃者
공격자	1. 攻撃者 2. 攻撃者
타닌산	タンニン
아스클레피오스	アスクレーピオス
토착의 동식물	原住民,アボリジニ
사유재산 몰수	おうしゅう,押収,ōshū
낚시질	魚釣り,釣り
숨막히게 더운	1. mushiatsui,蒸し暑い,むしあつい 2. 官能的
찻숱가락	ティースプーン,小さじ
경묘한	明るい,あかるい,明い,akarui
종자식물	顕花植物
엑스칼리버	エクスカリバー
소형 연식 비행선	飛行船
감탄사	しゃせい,感動詞,感嘆詞,間投詞
노련한 선원	水兵,船員,ジャック,水夫
결백하게	綺麗に
신세계	新世界
마법사	1. 魔人,まじん,majin,ウィザード,魔法使い,魔術師 2. 魔法使い
큰스푼	スプーン,さじ
신생대	新生代
수세 도급인	農家
민주주의	1. 民主主義 2. 共和制,民主主義
마법의	マジック
조류학자	鳥類学
입자 가속기	粒子加速器,加速器
시성식	列福
준엄한 추궁	反対尋問
검시관	検死官
점액종중	兎粘液腫
약점이 있음	zeijakusei,ぜいじゃくせい,脆弱性
종합적 체계	宇宙
사우디아라비아	サウジアラビア
딴 데로 돌리다	気をそらす
꼬마요정	エルフ
파라과이 사람	パラグアイ
위압하다	強要する
유료도로	高速道路
천궁도	ホロスコープ
변복조 장치	モデム,変復調装置
디플레이션	1. デフレーション 2. デフレーション
화석 연료	化石燃料,石油
천공충	木食い虫
과대평가	過大評価
플란넬 케이크	パンケーキ
계리사	会計士
코발트색	コバルト
종이접기	折り紙,折紙
매머드	マンモス
난세포	卵子
망명자	難民
환원효소	還元酵素
스웨덴	スウェーデン,瑞典
메가폰	メガホン
필사적으로	緊急に
프라이팬	フライパン
평가 하다	批評する
낚싯대	釣り竿
탄력성	だんせい,弾性,柔軟性,弾力性
가톨릭	カトリシズム
경문가	モテット
신할라어	1. シンハラ語 2. シンハラ語
신할라이	シンハラ語
사임하다	1. 辞職する,辞任する,辞める 2. 辞職する,辞任する,辞める,退位する 3. 辞職する,辞任する,辞める
철광석	鉄鉱,鉄鉱石
바로 그대로	きっかり
맨말에	禿げ
남색자	男色者,だんしょくしゃ
스위스	スイス連邦,スイス,瑞西
낙수홈	ガーゴイル
인스턴트 커피	インスタントコーヒー
실용적이 아닌	非実際的
내뿜다	嘔吐する,嘔吐,吐く
유럽 공동 시장	EU,ヨーロッパ連合,欧州連合
샌프란시스코	サンフランシスコ
탈레반	ターリバーン
전기화학	電気化学
애들레이드	アデレード
키보드	キーボード
거짓말하는 버릇	1. 虚偽の 2. 虚偽の
타르머캐덤 도로	アスファルト舗装路,ターマック
낚싯배	漁船
신경세포	ニューロン,神経細胞
관념학	イデオロギー
식사량	食事
회토산화물	ランタノイド,希土類
고등어	サバ
평화로운	静かな,晴れた
신속히	さっさと
씨의 솜털	昏睡
리소좀	リソソーム
맞바람	逆風
과녁판	魔法のつえ
신시대	時代,じだい
낙성식	就職
검사자	インスペクター
큰소란	喧々囂々,騒ぎ,騒音,騒動,猥雑
낭만주의 운동	ロマン主義
골동품	骨董品
카리스마적 매력	教祖的指導力
아리스토텔레스	アリストテレス
찻숟가락	ティースプーン,小さじ
소아과 의사	小児科医
웨스트벵골 주	西ベンガル,西ベンガル州
과학기술자	工兵,機関士,技術者,こうへい,エンジニア,技師
알쏭달쏭한	絶対の
3차어	3次的な,3番目の
시에나색	シエナ土,シエナ色
편재하는	普遍的
난센스	美辞麗句,珍紛漢,ちんぷんかんぷん
하찮은 일	蛇足,バガテル
세계 보건 기구	世界保健機関
명성있는	有名な,nadakai,なだかい,名高い,高名な,有名
고드름	つらら,氷柱
12면체	正十二面体
떨리는 목소리	さえずる
심술난	怒りっぽい,不機嫌な
건습계	乾湿計
알바니아	アルバニア
개체성	個人主義
리스본	リスボン
...에 알맞아	作為的な,意識的な
차리다	服を着せる
시에나토	シエナ土,シエナ色
여자의장	議長,委員長,主席
결막염	結膜炎
비단 같은	subesube,すべすべ
후지 산	藤山,富士山
의 탄소순환	炭素循環
장단단격	ダクティル
광기의	気が狂った
미생물학	微生物学
다양하게	色々
키메라	キメラ,kimera
가벼운 식사	軽食,間食,スナック
나쁜짓	悪事,悪行
...에서 넘치다	あふれる
크세논	キセノン
포르투갈	葡萄牙,ポルトガル
편력하는	常識はずれ
감청색	花紺青
크랭크 축	クランクシャフト
실사회	実際の生活,実生活,実社会
증권 거래소	証券取引所
형식을 차리는	細部まで行き届いた
원기가 있는	さかん
공리 공론	イデオロギー
코카타르	カタル
프랑스의	1. フランスの 2. フランス語 3. フランス人
실생활	実際の生活,実生活,実社会
프랑스인	フランス人
심판하다	審判員
국제적으로	国際的に
퍼덕퍼덕 펄럭이는	だらしない
연1회의	毎年,毎年の
맛 있는	旨い,あまい,oishii,おいしそう,おいしい,風味のよい
베이루트	ベイルート
마천루	超高層ビル,摩天楼
귀부인	奥様,fujin,クイーン
투석기	1. スリングショット 2. トレビュシェット
베링 해	ベーリング海
킬로그램	キロ,キログラム
느낌표	！,感嘆符
매정한	勘定高い,かんじょうだかい,kanjōdakai
모나코	モナコ,モナコ市
공회당	講堂
그래도	1. にもかかわらず 2. やはり,しかも,それにもかかわらず,それでも
매주의	毎週の
서둘러서	きゅうきょ
미크로네시아 연방	ミクロネシア,ミクロネシア地域
창포의 일종	ショウブ
돌대가리	うすのろ,でくのぼう
국제법	国際法
진열창	ショーウィンドウ
자웅화동체의	1. 両性具有 2. 両性具有
남녀 혼합의	交じった,混合した
과학의	科学的,科学的な
결혼 생활	kon'in,結婚,婚姻,こんいん
날카롭게	痛切に,切実に
실지 경험이 있는	実用的,経験豊かな,実際的,実践的,実務経験のある,実践的な
눈송이	雪花
칵테일의 일종	スクリュードライバー,ねじ回し
국정의	国立
신체적 허약함	1. 衰弱 2. 衰弱 3. 衰弱
팬케이크	パンケーキ
구제약	ターミネータ,明暗境界線,終端器,ターミネーター
오랑우탄	オランウータン
정량 분석	定量分析
공황의	パニック状態
과환기	過換気症候群
조사하다	1. 研究する 2. 調査する 3. 検査する,調査する,質問する,調べる
지옥의	下の
구조자	救世主
늠향 측정 단위	デシベル
소품얘기	短編小説
아이스퀼로스	アイスキュロス
임피던스	インピーダンス,電気抵抗,抵抗
그렇다	そう,ああ,ええ,うん
지우다	1. 消す 2. 置く
아이슬란드어	1. アイスランド語 2. アイスランド語
올라가기	1. 登り 2. 登り,昇天
군주국	君主制
국제화	国際化
성가신물건	迷惑,厄介者
북두칠성	北斗七星
굴절률	屈折率
2주간	二週間
나바호어	ナバホ語
현세적인	官能的
현지 시간	ひょうじゅんじ,標準時間,ひょうじゅんじかん,時
구조학	プレートテクトニクス
그라프	グラフ
중세기의 투석기	トレビュシェット
파성용의 큰 망치	破城槌
서브타이틀	字幕
관현의	権威のある
멜리사	レモンバーム,西洋山薄荷
근래에	最近,さいきん,saikin
투석포	トレビュシェット
상류에 있는	川上
관형사	1. 限定詞 2. 限定詞
공휴일	国民の祝日,祭日,建国記念日,祝日,休日,祝祭日
그렇소	きっかり
멘델레븀	メンデレビウム
혼인전 계약	婚前契約
공시적 연구	共時性
노폐물	ゴミ
근래의	最近,新しい
기념일	結婚記念日,誕生日,記念日
이상 기체	理想気体
그렇지	そう,ああ,ええ,うん
노퍽섬	ノーフォーク島
날의 사면	斜面
어떻게 해서든	やっぱり,tomokaku,とにかく,ともかく,兎も角,どうせ,何しろ
공간적인	空間的
기념품	土産
그렇고말고요	必ず,zehi,正に,是非,その通り,屹度,実に,確かに,確実に,きっと,ぜひ
먼지 방지용 외투	仕事着
수확 완료	収納
자동차 편승자	便乗者
인디애나폴리스	インジアナポリス,インディアナポリス
겁대가리	臆病,憶病
불가사의한 힘	マジック
제1지	足指,つま先
글러브	手袋
굶주림	1. 飢え,乾き,飢餓 2. 飢え,きが,うえ,飢餓
결혼 행진곡	結婚行進曲
투시력	透視
산림공원	植物園,森林公園
머뭇거리는 말	隣人,お隣
논하다	論ずる,議論,議論する
기대값	相加平均,算術平均
진정제	ヘロイン
램프셰이드	ランプシェード
지정학	ちせいがく,地政学
그리고	-も,また,も,さらに,にも
근로자	kōjin,kōfu,工人,こうふ,こうじん
알리바이	アリバイ
노하여	激怒した
백러시아어	1. ベラルーシ語 2. ベラルーシ人,ベラルーシ語
불가사리	hitode,ひとで,ヒトデ,人手
스파게티	1. スパゲッティ 2. スパゲッティ
어디에든	何処でも,どこでも,dokodemo,どこか
카피바라	カピバラ
메마른	不妊,不毛
동로마 제국	東ローマ帝国
리히텐슈타인	リヒテンシュタイン
중앙아프리카 공화국	中部アフリカ,中央アフリカ共和国
뇌질환	脳症
3인조	三頭政治
어디엔가	何処でも,どこでも,dokodemo,どこか
크게 벌어져 있다	欠伸する
솔직히	正直に
그립다	いとしい,itoshii
선수권 보유자	保護者,係員
광합성	光合成
2인자	二人称,第2の人
어디에나	1. 何処でも,どこでも,dokodemo,どこか 2. どこでも
상관시킴	相関
매음굴	妓楼,売春宿,ぎろう
장난치다	浮かれ騒ぐ
발리 섬	バリ島
제3자	第三者,三人称
장난치는	剽軽,hyōkin）
수목원	植物園,森林公園
3쌍 날개의 천사	熾天使
그리스	ギリシャ,ギリシア
이오 섬	1. 硫黄島 2. 硫黄島
면도칼	剃刀,かみそり,レザー
도움이 되다	慣れる
도움이 되는	親切な
도망할우려가 없는	安全に
세인트루시아	1. セントルシア 2. セントルシア
숨가쁘다	喘ぐ,息を呑む
욱일승천의 세력	優勢
숙박소	ホスピス
테이프 녹음기	テープレコーダー
망우수	蓮,ロータス
넓적다리뼈	大腿骨
진입로	出入用道路
피라미드 사기	無限連鎖講
맛있는	美味しい,おいしい
맛있다	旨い,あまい,oishii,おいしそう,おいしい,風味のよい
관용어법	成句,諺,ことわざ
추바시어	チュヴァシ語
의지적인	意識的な
헌책 파는 노점	本屋,書店,ほんや,hon'ya
감마 방사선	ガンマ放射線
맨앞의	主な
되는 대로 다루다	嘘をつく
셔틀콕	羽根つき,羽根
그리핀	グリフォン
미국 중남부의 주	オクラホマ州,オクラホマ
지원의	志願して
아메리카 표범	パンサー,ジャガー,ヒョウ,ピューマ,豹
지원자	志願者
글루텐	グルテン
공동작업	共和,協働
모국어	母国語,母語,bogo,ぼご
망원경	望遠鏡
균분법	方程式
공인하다	合法化する
통탄할	悲しい
공동작용	相乗効果
아삼 주	アッサム州
퇴직자	退職者
자동 무선	トランスポンダ
매사추세츠	マサチューセッツ
냉담한 사람	つらら,氷柱
관심을 끄는	魅力的
진부한 말	決まり文句
원자 시계	原子時計
음향 상태	音響,音響学
모권제	家母長制
뻔뻔스럽게	思い切って
졸음이 오는 듯한	nemui,ねむい,眠い,眠
짜임새	前後関係,状況,文脈
말재롱	しゃれ,駄洒落,ダジャレ,語呂合わせ
아 주시오	感謝する
말의사	装蹄師,鍛冶屋
권적운	巻積雲
예쁘장하게	綺麗に
여유같은	巧妙な,狡い,ずるい,狡猾,悪賢い
기린자리	麒麟,ジラフ,キリン
눈부신	眩しい
스트론튬	ストロンチウム
벤조디아제핀	ベンゾジアゼピン
망아지	子馬
집념어린	慢性的な
치매가 된	気が狂った
가속도 단위	ガロン
마이클	ミカエル,マイケル
마이크	マイク,マイクロフォン
일시적 흥미	軟派
면도기	剃刀,かみそり,レザー
지질학	地質学
지진학	地震学
목걸이	首飾り,ネックレス
만자문	卐,卍,ハーケンクロイツ
당좌 예금 구좌	当座預金
정신의학	精神病学
대서양의 영령군도	バミューダ,バーミューダ
뻔뻔스러운	生意気な
근면한	勤勉
비싸지 않은	やすい,yasui,安い,hikui,安価
대륙 사면	tairiku-shamen,たいりくしゃめん,大陸斜面
머리칼	1. たてがみ,毛,髪,鬣 2. 毛
유리 끼우기	ガラス工
프렌치 드레싱	ヴィネグリットソース
정말이냐?	そう,ああ,ええ,うん
형이상학	形而上学
토하다	1. 嘔吐する,嘔吐,吐く 2. 吐く
kamera	カメラ,写真器,kamera,写真機
심미적인	美的な
빙하 시대	氷河期
과용하다	酷使する
걸어서건너다	よちよち歩く,よたよた歩く
좁은후미	ブレスレット
아드리아 해	アドリア海
멧돼지	イノシシ,猪
상대적으로	比較的,比較的に
수시로	しばしば
마유주	馬乳酒,クミス
안경원숭이	メガネザル
정신이상	精神異常
통보하다	通告,知らせる
아마릴리스	彼岸花
덕이 있는	よい
의심하는	ayashii,怪しい,怪しむような,疑いの,あやしい
엄지 손가락	親指
카복실산	カルボン酸
결혼 반지	結婚指輪,ウェディングリング
목각술	木版画
소폭동	乗っ取り,謀叛
정보과학	情報学
주 장관	保安官
연속 가정극	昼ドラ,昼メロ,ソープオペラ,昼ドラマ
지중해	地中海
아비시니아	エチオピア,アビシニア
히브리의 사사	サムエル記
머리말	1. じょし 2. じょし
원심분리기	分離器
괴팍한	怒りっぽい,不機嫌な
수수익	利益
브라자빌	ブラザヴィル
외국산의	esotica,エキゾチック
1월	いちがつ,1月,睦月,一月
2월	二月,如月,にがつ,2月
진주빛	梨,梨の実
타고나기를	勿論,もちろん,当然
7월	shichigatsu,七月,文月,7月,しちがつ
8월	葉月,8月,八月,はちがつ
9월	くがつ,九月,9月,長月
3월	さんがつ,3月,sangatsu,３月,三月
4월	四月,4月
6월	六月,ろくがつ,水無月,6月
소품 피아노곡	短編小説
흐루쇼프	フルシチョフ
제왕 절개	帝王切開
말없음	無口
자기 컴퍼스	方位磁針,hōijishin,ほういじしん
메뚜기	バッタ,きりぎりす
튀링겐 주	チューリンゲン
일시적 현상	菌類,きのこ
선태류의 식물	苔植物
전자기 스펙트럼	電磁スペクトル
폴란드어	1. ポーランド語 2. ポーランド語,ポーランド
막연히	itsumademo,何時までも,いつまでも
국민적 감정	国籍,こくせき
헌 물건을 파는	中古
집요한	ごますりの
브루타뉴어	ブルトン語
중국지역	中華民国,中國,台湾
시작되다	始める
국민 투표	国民投票,レファレンダム
시칠리아섬	シシリー,シチリア州,シチリア島,シシリー島
과거 시제	1. 過去時制,過去 2. 過去形,過去時制,過去
명주 원숭이	マーモセット
브라이튼	ブライトン
투우술	闘牛
신뢰할 수 없는	心許ない
코트디부아르	コートジボワール
말없는	寡黙,無口
진창인	浸水した
쇠약한	やつれた
정신측정학	サイコメトリー
부정행위	不当,不當
바짝 줄인	わずかな
쉐어웨어	シェアウェア
다이애드	二和音
변화가 많은	不定な
계속해서	1. 連続的に 2. 絶え間なく,いつも
근본 가설	いろは
말쑥한	ひとりよがりの
강요하다	1. 強制する 2. 強要する
크랭크샤프트	クランクシャフト
구충제	駆虫剤
글라이더	グライダー
투우사	1. 闘牛士 2. マタドール
<시간	優先権
원자 번호	原子番号
살균하다	殺菌する
비상식의	かたはらいたい,馬鹿らしい,kataharaitai,片腹痛い,馬鹿な
분자 유전학	分子遺伝学
부드러운 물건	sotto,そっと
활기에 찬	さかん
다시 도착하다	取り戻す
숫보기	小児,赤ちゃん,赤ん坊
계속하다	保つ
구치소	けいむしょ,ペナルティーキック,かんごく,刑務所,監獄,ダンジョン
규산염	ケイ酸塩
다이오드	ダイオード
마음을 먹다	思い切る
터키의 수도	アンカラ
정보기술	情報テクノロジー,IT,情報技術
차이콥스키	チャイコフスキー
어떻든지	なぜか
돌발 홍수	鉄砲水
정신 병자	人格障害
투자자	とうしか,出資者,投資家,しゅっししゃ
누벨칼레도니	ニューカレドニア
채찍질하다	鞭打つ
우주 정거장	宇宙ステーション
뇌일혈	卒中,脳梗塞
지근거리다	圧迫
피타고라스	ピュタゴラス,ピタゴラス
전문적인 무용가	舞踊家,踊り子,ダンサー
마닐라삼	マニライトバショウ,マニラアサ
수세공	手工芸
백색왜성	白色矮星
웨스트버지니아	ウェストバージニア
소택지	沢,湿原,湿地
이웃사람	1. 隣人,お隣 2. 隣人,お隣
파고다	五重塔,パゴダ
독단적인	断定的な
기러기	1. 鵝鳥,ガチョウ 2. 鵝鳥,ガチョウ 3. 鵝鳥,ガチョウ
연금술사	アルケミスト,錬金術師
콜라주의 작품	コラージュ
명기수	ケンタウルス族,ケンタウロス
페레스트로이카	ペレストロイカ
고가 도로	ガード
관능적인	官能的
통행인	通行人
뉴델리	ニューデリー
눈사람	雪達磨,雪だるま
귀엣말	こごえ,私語,小声
보석 물리는 데	斜面
핵무기 보유국	かくほゆうこく,kakuhoyūkoku,核保有国,原子力
에메랄드	1. エメラルド 2. エメラルド 3. エメラルド
사용하기 좋은	ben na,べんな,便な
귀엽게	綺麗に
국민 학교	しょうがく,学校,小学校,しょうがっこう,shōgakkō
허리케인 전투기	ハリケーン,大暴風
오르내리는 변동	波動
필요 조건	前提
창녀집의 포주	売春婦,娼婦,パンスケ,ばいしゅん,させ子,売女,街娼
스며 나오게 하다	しくしく泣く,すすり泣く,泣く
메신저	ツアーコンダクター,宅配会社,メッセンジャー,旅行添乗員,つかい,運送会社
통역자	1. 通訳者 2. 通訳者 3. 翻訳者,通訳者
샴페인 색	シャンパン,シャンペン,シャンパン色
금붕어	金魚
실개울	おがわ
나아가다	上達する,上達させる,改善,良くなる,改善する
소화기	消火器
유혹의 포로	蛾,が
약물 동력학	薬物動態学
메시아	救世主
모로코	モロッコ
7月	shichigatsu,七月,文月,7月,しちがつ
양배추 샐러드	コールスロー
소화병	手投げ弾,手榴弾
도덕적인	よい
기르다	飼う,食べさせる
뗏목 배	カタマラン
테티스	テティス
신교도	プロテスタント
부정적분	ふていせきぶん,不定積分
칸나다어	カンナダ語
대가리	頭蓋骨
멕시코	メキシコ,メキシコ市,墨西哥
신교리	新語
튀김들	メノウ
증폭기	アンプ,増幅器
네델란드의 수도	アムステルダム
목마름	1. 飢え,乾き,飢餓 2. 乾き 3. 飢え,乾き,飢餓
하루밖에못사는	短命な,はかない,束の間の
시금석	試金石
대가족	家族
정상상태로는	いつもは,俗,通常,tada,何時も,一般に,日頃,大抵,普通に,ただ,いつも
흥겨워하다	笑う,笑い飛ばす,一笑に付す
지구 온난화	地球温暖化
통용어	方言,ほうげん,訛り
낮게 평가하다	過小評価する
큰 낫	大鎌,鎌
소화전	消火栓
고베 시	神戸市,,神戸
신경학	1. 神経学 2. 神経学
면하기 어려운	必至の,恒常的,避けがたい,常習,避けることのできない,必至,不可避
귀에지	耳屎,耳垢
외할아버지	外祖父,祖父,そふ,お爺さん,おじいさん,sofu
늑막염	胸膜炎
마멀레이드	ジャム,マーマレード
신나게 뛰놀다	浮かれ騒ぐ
깨달음	哲学
기울이다	傾く
버스 정류소	バスストップ,停留所,バス停
교향곡	1. 交響楽団,交響曲 2. 交響曲
소화탄	1. ざくろ,榴弾,グレネード,りゅう弾 2. 手投げ弾,手榴弾
수영복	水泳着,水着,海水着
수오리	アヒル,カモ,かも
대과거	過去完了
대검집	さや,鞘
당국의	権威のある
계출하다	通告,知らせる
식기장	todana,とだな,戸棚,食器棚
상호 관계	相互関係
모래톱	砂丘
시금치	1. ホウレンソウ 2. 法蓮草,ホウレンソウ,ほうれん草
기모노	和服,きもの,着物
수영장	プール
가정내 폭력	家庭内暴力
습도계	湿度計
신기루	1. 蜃気楼 2. 蜃気楼
70인 번역 성서	七十人訳聖書
늘리다	増やす,増す,増加する
생물학의	生物学
재주있는	hashikoi,はしこい
다뉴브 강	ドナウ川
십각형	十角形
명민한	1. 明敏 2. 明敏
명민함	すばやさ
대격의	批難,非難
십계명	モーセの十戒
잘츠부르크	ザルツブルク
싱겁다	退屈な
수요일	suiyōbi,水曜日,すいようび
자업자득일세	感謝する
수수께끼의 인물	謎,nazo
집착력	忍耐,堅持
명백한	明確な,明確
수확 축제	収納
갑작스런	突如な,突然
전기영동	電気泳動
신기원	時代,じだい
일치하는	同じ,同時
여호수아	ヨシュア記
순수입	利益
우쭐케하다	お世辞を言う,諂う
아무데도	何処でも,どこでも,dokodemo,どこか
교할한	巧妙な,狡い,ずるい,狡猾,悪賢い
검시 해부	検死
토탄이 많은	泥炭
스노클	スノーケル
근사한	有名に
신문 경영자	発行人,出版社
안드라프라데시 주	アーンドラ・プラデーシュ州
853.2미터	海里,マイル
수신인	受取人
미를 아는	美的な
재 통일	再会
투르크	トルコ人,トルコ語
쇼윈도	ショーウィンドウ
시간대	標準時
투명도	透明性
미늘살 창	ルーバー
잘되지 않은	不成功
아프리카어	アフリカーンス語
테헤란	テヘラン
권층운	巻層雲
모눈종이	グラフ用紙
순시자	hōkyaku,kyakujin,訪客,きゃくじん,客人
따분하게 하는	退屈な
텔레비전 카메라	カメラ,写真器,kamera,写真機
산화철 가루	サフラン
투명성	透明性
대기압	1. 気圧 2. 気圧
매춘부	1. 売春婦 2. 売春婦,娼婦,パンスケ,ばいしゅん,させ子,売女,街娼
교활한	1. 巧妙な 2. 巧妙な 3. 巧妙な,狡い,ずるい,狡猾,悪賢い 4. 狡猾な
시계공	oro-rojisu-tu,時計屋
민중 선동	扇動,デマ
시간외	残業,オーバータイム
아프리카너	アフリカーンス語
야비한 사람	ブタ,豚
귀중한	かちたかい,価値高い,kachitakai,貴重,大切な
상호관계가 있음	相互関係
몰디브	モルジブ,モルディブ
깜짝 놀라	びっくりする
시골길	規定航路,細道,路地
우스꽝스러운	可笑しい
명명법	学術用語,術語,専門語,命名法
거시경제학	巨視的経済学,マクロ経済学
중재하다	仲介する
토착민	原住民,アボリジニ
그럴 듯하게	tabun
mu	ダイコン
불가리아	ブルガリア
기밀의	気密,密閉
초고속 도로	高速道路
전멸시키다	senkei
숙고하다	1. 考える 2. 考える,熟考する
민족격리	アパルトヘイド,アパルトヘイト
대륙 이동	大陸移動
투명화	透明性
투명한	透明,透明な
그순위	優先権
3부작	三部作
춤추는 사람	舞踊家,踊り子,ダンサー
소피아	ソフィア
시각화	映像化,可視化
시거의	タキメーター
시간표	1. 時刻表 2. 時刻表
중미의 공화국	グアテマラ
명명일	聖名祝日
균없는	不妊,不毛
퇴보하다	悪化する,低下する
소행성	星状体,小惑星
당나귀	驢馬,ロバ
5변형	五角形
지키다	まもる,守る
두문자어	略語,頭字語,アクロニム,akuronimu
교황청	バチカン市国
템플렛	型板
슬라브	スラブ,スラヴ
컴퓨터 용어	パスカル
맞춤법	正書法,文字,文字綴り,オーソグラフィー,綴り,スペリング
독나방의 일종	尼,尼僧
야단법석의	賑やかな
아무르강	アムール川
카슈미르어	カシミール語
일정 불변하게 늘	決まって,かならず,renjitsuren'ya,連日連夜
양모 선별공	ホッチキス
구하다	こう,請う
순전히	絶対に
진통제	1. 痛み止め,鎮痛剤,鎮静剤 2. 軟膏
투발루	ツバル
2분법	二分法
부다페스트	ブタペスト,ブダペスト
수증기	蒸気,湯気,気体
기부금	1. 寄付 2. プレゼント 3. 寄付 4. 寄付 5. 寄付,プレゼント
혹사당하는 사람	農奴,小作人
증후학	記号学
종신 연금	永世
명멸광	ランタン,提灯
안경 원숭이	メガネザル
미크로네시아 지역	ミクロネシア,ミクロネシア地域
리포솜	リポソーム
술고래의	酔っ払う,酔っ払い,酔う,酔い
성당 참사회장	学寮長
문인사회	interi
글쇠판	キーボード
평행 4변형	平行四辺形
간직하여 두다	授与する
원자 이동	移住,回遊
베이킹 파우더	ベーキングパウダー
말의 엉덩이	尻,ケツ
슬로건	スローガン,標語
13	十三
부패시키다	腐る
3부곡	三部作
컴퓨터 언어	プログラミング言語,計算機言語
PR	パブリック・リレーションズ,PR,ピー・アール
재생 이용	リサイクル
3배로	三回
스릴러	スリラー
찡그린 얼굴	しかめっ面
혼례 과자	ウエディングケーキ,wedingukeeki,ウェディングケーキ
인력이있는	魅力的
마녀의 하나	メドゥーサ
튀니스	チュニジア,チュニス
사회 언어학	社会言語学
미생물로분해되는	自然分解出来る
국화과	キク科
오레가노	マジョラム,オレガノ
환영 같은	超現実的
끈적끈적한것	スライム,ぬめり
트빌리시	トビリシ
균일성	画一性,統一性,普遍性
몰도바	モルドヴァ,モルダビア,モルドバ
케이블카	鋼索鉄道
비위맞추어	誑す,丸め込む,強請る
용기를 돋우는	こころづよい,心強い
부정직한	巧妙な
마케팅	マーケティング
진테제	総合判断,合成
깃털공놀이	羽根つき,羽根
고기젤리	アスピック
부가하다	合併する
급속히	1. さっさと 2. 早々,早速
댄스 교사)	踊り
증후군	症候群
국내 총생산	ジーディーピー,国内,国内総生産
보복하다	1. 払う 2. 交換する,返す
메노파 신도	メノナイト
무수 규산	ケイ素二酸化物
불멸의 도읍	ローマ
산딸나무속의 식물	ミズキ,ミズキ属
회전하다	曲る
금속회	石灰
쌍곡선	双曲線
튀니지	チュニジア
세입 증가	税金,税
뼈오징어	コウイカ
팩시밀리	ファクシミリ,ファックス
플레잉카드	カード,カルテ,札,トランプ,トランプ・カルタ,カルタ
토카타	トッカータ
꽃양배추	カリフラワー
유대인의 분산	四散,ディアスポラ
4면체	四面体,三角錐
적극적으로	かならず
건지 섬	ガーンジー島,ガーンジー
정강이뼈	keikotsu,けいこつ,脛骨
믿음직하게 여기는	堅い
바꿔 말하면	つまり,すなわち
네오디뮴	ネオジム
맹장염	盲腸炎,虫垂炎,chūsuien
빨리 지나가는	はかない,hakanai,儚い,儚い (はかない)
다각화	万状
수입국	ゆにゅうぎょうしゃ,輸入業者,yunyūgyōsha
다각형	多角形,たかっけい,たかくけい,takakukei,takakkei
몬트세라트	モントセラト島,モンセラト,モントセラト
식기세척기	皿洗い,食器洗浄機,皿洗い機,食器洗い機,食洗気
6면체	六面体
신기한	未曾有
새끼 돼지	子豚
방해하다	禁ずる,禁止する,禁じる
진폐증	肺塵症
마취사	麻酔科医
아무래도	やっと,ついに,結局,最終的に,とうとう
명령권	命令
국화속	菊,kiku
인테르링구아	インターリングア語,インターリングア
인텔리 계급	interi
대차대조표	バランスシート,貸借対照表
구혼자	kare,カレ,カレシ,kareshi,かれし,ボーイフレンド
수입자	ゆにゅうぎょうしゃ,輸入業者,yunyūgyōsha
마카오	マカオ,アオメン,澳門
극히 조금	なごり,痕跡,足跡
따라잡다	追い越す
순응성	だんせい,弾性,柔軟性,弾力性
수족관	養魚鉢,水族館
8리터	ガロン
멜버른	メルボルン
지하도	地下道
수정관	精管
지하드	遠征,ジハード
정밀하게	1. 心地よく 2. 正確に 3. 正確に
7가 원자	shichi,七
목덜미	項,襟首
안마하다	捏ねる,練る,こねる
방글라데시의 수도	ダッカ
수자폰	スーザフォン,チューバ
직면하다	侮辱する
행실이 나쁜여자	情婦
순이익	利益
그림 전시회	えいが,eiga,映画
가소성의	粘性
그위에	やはり,しかも,それにもかかわらず,それでも
지평선	横の,横,水平な,水平
눈을 깜박거리다	チラ見する,パッシングする,点滅する,まばたきする
시장가격	実勢価格,相場
스파르타	スパルタ
전기이동	電気泳動
아바나 여송연	ハバナ
소비에트	ソヴェト,ソヴェトの,ソ連,ソ連の,ソビエトの,ソビエト
지팡이	ステッキ,杖,つえ
높은 이자를 받는	とんでもない
타고난 지혜	常識
단검표	方尖柱,オベリスク
독일의 강	ドナウ川
시적인 문장	うた,詩的表現
절대 등급	絶対等級
누르스름한	黄色い
맥주집	酒場
대립 교황	対立教皇
몸 야위는 법	化学的還元
초과 근무	残業,オーバータイム
어딘 가에	どこかに
갈리시아어	ガリシア語
104번 원소	ラザホージウム,ラザホルジウム
간단한 장치	機器,小物,こもの
단핵 백혈구	一輪車
고트족의	ゴシック式の
말똥가리 무리	若専
수종병	浮腫,水腫
먀오족	ミャオ族
실업자수	失業
산마리노	1. サンマリノ,サン・マリノ 2. サンマリノ,サン・マリノ
밤의 유흥	夜遊び
의지하다	1. 頼る,あてにする 2. 頼る,たくらむ
개축하다	建て直す,再建
술고래	酒飲み,愛飲家,アルコール中毒者,飲んべえ,小虎,飲兵衛,辛党,飲んだくれ
비상구계단	避難経路,火災非難設備,非常階段,非常口
모세관	毛管
괄약근	括約筋
교묘함	幸い,幸せ
수그린	故障
과야킬	グアヤキル
눅눅한	湿った
군국주의	軍国主義
원자 폭탄	原爆,原子爆弾
비뇨기학	泌尿器科学,泌尿器科
재정적후원자	天使,tenshi
치켜세우다	祝う
성직자	1. 司祭 2. 牧師,司祭 3. 司祭
지하수	湧水
직행로	航空会社
낳는 사람	父親,お父さん,父上,父,親父
우한 시	武漢,武漢市
아열대 지방	亜熱帯
공작령	公爵領,公国
고집센	頑固な
광학기계상	眼鏡屋
잡담의 모임	話々,世間話
목을 베다	打ち首にする
의지할 곳	信頼
공유지	パブリックドメイン
치장하게 하다	装わせる
면역학	免疫学
소경거미	ザトウムシ,盲蜘蛛,足長おじさん,座頭虫
목사님	牧師
세탁용 알칼리액	苛性アルカリ溶液
석류 시럽	グレナデン・シロップ
지하철	メトロ,地下鉄
꾸러미를끄르다	開く
공작석	くじゃく石
1루수	ファースト,一塁手
궁둥이	1. 尻 2. 頬 3. 尻,ケツ 4. 尻,ケツ
보츠와나	ボツワナ
성공하지 못한	不成功
짐짓...체하는	小刻みな
설치 동물	けっ歯動物,齧歯動物,齧歯類
보르네오섬	ボルネオ島
수단)	スーダン
넙치류	カレイ,鰈
모순된	不調和な
체중감소법	化学的還元
마니푸르 주	マニプル,マニプル州
단언하다	1. 断言する 2. 断言する 3. 公言する 4. 喧伝する,言い切る,断言する,確言する,主張する,強弁する,言い張る 5. 断言する
멍청이	うすのろ,でくのぼう
명예심	1. 野心,大望 2. 野心,抱負,アンビション
공언자	教授
여자댄서	バレリーナ
킬롬미터	キロメートル
여자다운	onnarashii,女らしい,おんならしい
...이 아니다	ぎりぎり
세입청	情報検索
성좌의	1. 恒星の（こうせいの,星の 2. 恒星の（こうせいの,星の
Dominika	ドミニカ国,ドミニカ,Dominika,どみにか
어디라도	何処でも,どこでも,dokodemo,どこか
상호의	互い
관악기	kangakki,かんがっき,管楽器
외연적인	明晰な
지휘권	命令
...을 뜻하는	重大な
고전학	貨幣学
증권 매매인 조합	証券取引所
코모로스	コモロ
경청자	聴衆
그렇지만	やはり,しかも,それにもかかわらず,それでも
퇴위하다	辞職する,辞任する,辞める,退位する
상하이	上海,上海市
소별장	賭場
부권사회	家父長制
성적인	セクシーな,セクシー
즐겁게 하다	はしゃぐ
진화론	ダーウィニズム
일깨우다	思い出させる
세이셸	1. セイシェル 2. セーシェル,セイシェル
간과하다	切り捨てる
진홍색	ポピー,ケシ色,ケシ,ヒナゲシ
멕시코 시티	メキシコシティ
삽화가	イラストレーター
포도나무	ぶどう園,ブドウ園
주정뱅이의	酔っ払う,酔っ払い,酔う,酔い
명제 계산	命題論理
말레이지아 수도	クアラルンプール
젖 짜는 여자	乳しぼりの女
관음자	出歯亀,覗魔
속바지	ズボン,パンツ
목 달아매는 끈	ネクタイ
기쁨에 넘쳐	うれしく,運良く,楽しく,ureshiku
소방차	消防車
관재료	運河,キセル,パイプ
촉매 컨버터	触媒コンバータ
서지학	参考文献,しょし,書誌学,書誌,文献目録
감마선 방사	ガンマ放射線
관장약	ちゅうにゅう,chūnyū
동맥경화	動脈硬化症
방황하다	散歩する
살기어려운 곳	ディストピア
통속성	人望,にんき,じんぼう,ninki,jinbō
물가에	上陸,陸上,陸上に
신경과학	神経学,神経科学
통상의	いつもの,tada,ただ
자동인형	じんぞうにんげん,人造人間
사회학	社会学
손바닥	palmo
아마 같은	亜麻
산화제	オキシダント,酸化剤
믿어지지 않는	驚異的な,インクレジブル,ありえない,飛躍しすぎている,信じられない
산호초	堡礁,サンゴ礁
성유법	擬音語,ぎおんご,擬声,オノマトペ,擬声語,擬声擬態語,擬音
구명정	救命ボート
생태학	生態学
푸른 완두	エンドウ,豌豆,エンドウ豆
그칠사이 없이	いつも
무교양	唯物論
가스 성분 측정기	ユーディオメーター
소방수	消防士
소방서	1. 警察署 2. 消防署,消防,しょうぼうしょ,shōbōsho,shōbō
눈두덩	まぶた,瞼
관절염	関節炎
고참병	古兵
산후안	サンフアン
때리는 사람	ビーター
사회자	議長,委員長,主席
속박감	狭窄
산화물	酸化物
숨은 미인	シンデレラ
섬유소	セルロース,繊維素
별 게 아닌 것	乱雑
골짜기	1. 谷 2. たに,谷,tani
신경계통	神経系
...보다낫다	越える,超える
터키인	トルコ人,トルコ語
터키의	トルコの,トルコ語
사후에	死後
터키어	1. トルコ人,トルコ語 2. トルコ語 3. トルコの,トルコ語
잡는 사람	キャッチャー,捕手
소방대	消防隊
관장기	スポイト,注射器
손목뼈	リスト,手首
격투기	武術,格闘技
변화시키는 것	変流器,トランスフォーマー,変圧器
생태계	生態系
사형실	ガス室
구르카	グルカ兵
남극 대륙	南極,南極大陸
집회소	ニュースグループ
뇌막염	髄膜炎
사회당	社会主義
바다 여행	水兵,船員,ジャック,水夫
신시사이저	シンセサイザー,音源
그레이비	グレービー
구름의	くもり,(kumori)
과자점	菓子類
삼륜오토바이	三輪車
국립의	国立
과달로프	グアドループ,グアドループ島
성예전	秘跡
골질의	やつれた
솔리톤	ソリトン
빨간 아닐린 물감	マゼンタ,マジェンタ
토양학	小児科学,小児科
테킬라	テキーラ
카톨릭교 신앙	カトリシズム
트럼펫 부는 사람	トランペット
마셜 제도	マーシャル諸島共和国,マーシャル諸島
처음에는	本来
솜사탕	綿菓子
활차 장치	滑車
단편으로 이루어진	切れ切れの
구별된	慎重
국민의	国立
툰드라	1. ツンドラ 2. ツンドラ,凍原
세척제	ローション,化粧水
육체미 조형	ボディビル
세르비아-몬테네그로	セルビア・モンテネグロ
우편물 집배인	郵便配達人
아스마라	アスマラ
신고전주의	新古典主義
유리 끼우는 홈	斜面
광전자	光電子
그랑프리	グランプリ
모반점	あざ,aza
정백동염	副鼻腔炎
자궁 절제	子宮摘出術
Hanja	足す
식욕부진	拒食症,神経性無食欲症
수뇨관	尿管
통신사	通信社
군비 축소	軍縮
철통같은	気密,密閉
고치다	上達する,上達させる,改善,良くなる,改善する
손수레	手押し車
루이지애나	ルイジアナ州
통신원	ジャーナリスト,記者,リポーター,報告者
울란바토르	ウランバートル
아침 식사	昼食
5대호	五大湖
재난의 씨	茶目
손쉽게	実際に,現在,現在は
소수점	小数点
성인 같은	神聖な
손수건	ハンカチ,ハンカチーフ
그럼은요	必ず,zehi,正に,是非,その通り,屹度,実に,確かに,確実に,きっと,ぜひ
예수 그리스도	イエス・キリスト,みこ,イエスキリスト,キリスト
손가락의	デジタル
눈구멍	軌道
프랑스령 폴리네시아	フランス領ポリネシア,仏領ポリネシア
울란바타르	ウランバートル
술꾼의	酔っ払う,酔っ払い,酔う,酔い
광우병	きょうぎゅうびょう,kyōgyūbyō,狂牛病
리큐어술	リキュール
만 형성	wan'nyū,わんにゅう,湾入
관주법	灌漑
거대하다	莫大な,dekai,dekkai,莫大,でかい,広大,でっかい,広大な,大きい,巨大
노비알	ノヴィアル
사이보그	サイボーグ
지나치게 서두르는	突然
귀족다운	誇り高い,hokoritakai,ほこりたかい
간편화의일종	怠け者
생화학	生化学
명세표	計画,議事,日程
세척기	スポイト,注射器
국민군	民兵
산타 클로스	サンタクロース
부주의한	偶然の
국민성	国籍,こくせき
무고기	指関節
샴페인	シャンパン,シャンペン,シャンパン色
소섬유	繊維
소방 기구고	消防署,消防,しょうぼうしょ,shōbōsho,shōbō
도미문의	1. 周期的 2. 周期的
손목 시계 밴드	ブレスレット
공격수단	弾薬
설치류	けっ歯動物,齧歯動物,齧歯類
이름의시조	1. 名祖 2. 名祖
탐욕스러운	熱心な
관중석	講堂
몸이 좀 아픈	病気
말하다	1. 言う 2. 物語る,教える 3. 言う 4. 言う
속생설	生合成
스와힐리 말	スワヒリ語
속삭임	こごえ,私語,小声
어떻게든지 해서	1. ひょっと,tabun 2. 万一,ひょっと,tabun,多分,若しや,まんいち
7년간	shichi,七
급료생활자	賃金労働者
매우 짧은	高潮
오키나와	沖縄島,沖縄本島
성찬대	供物台,祭壇,聖餐台
에스토니아	エストニア
방뇨하다	小便をする,おしっこをする
소성단	星屑,スターダスト,sutādasuto,ほしくず
샹파뉴	シャンパン,シャンペン,シャンパン色
교수법	教授法,てじゅん,授業
기계 번역	機械翻訳
솜씨있게	綺麗に
바바리아	バイエルン,バイエルン州
숨기는	口堅い,口が堅い
정신 감응	いしんでんしん,テレパシー
디트로이트	デトロイト
무당벌레	テントウムシ
소설가	小説家
마피아	黒手党,秘密集団,マフィア
모호한말을쓰다	嘘をつく
교수형	絞首台,絞首刑
퇴보한	悪化する,低下する
사수자리	射手,shashu,しゃしゅ
모르핀	モルヒネ
그럭저럭	なぜか
선취권	優先権
생합성	生合成
세대간의 단절	:ジェネレーションギャップ
독립 국가 연합	どくりつこっかきょうどうたい,独立国家共同体
공동묘지	墓地
구직광고	求人広告
원작의 모사	レプリカ,複製,写し,模造品
어디론가	どこかに
일이 없는	失業者
핫 팬츠	ホットパンツ
마푸토	マプト
연쇄 살인범	連続殺人
거듭홀소리	二重母音
... 하고 싶다	その内,実際に,今
눈꺼풀	まぶた,瞼
몽롱한	kasumi
신원 도둑질	アイデンティティの盗難,個人情報漏洩
점검열람	調査,点検
이용하다	上達する,上達させる,改善,良くなる,改善する
해결이 어려운	不可解な
반드러운	subesube,すべすべ
크리스마스	1. クリスマス 2. クリスマス
카프카스	カフカース
2극 진공관	ダイオード
숯가마	石炭鉱区
토요일	土曜日,doyōbi
관현악단	オーケストラ,ōkesutora
1다스	jūni,じゅうに,十二,ダース
교수대	絞首台,絞首刑
판사의 사실	カメラ,写真器,kamera,写真機
5능보	五角形
철갑 상어	チョウザメ
노스캐롤라이나	1. ノースカロライナ 2. ノースカロライナ
먼저임	優先権
키릴로스	キリル,シリル
오클랜드	オークランド
만화경	mangekyō
토오쿄	帝都,とうきょう,Azabu,東京
곤충학	昆虫学
시행정 담당관	市長
영구 동토대	永久凍土
토론학	hōigaku,法医学,ほういがく
통치하다	通告,知らせる
그림 문자	ピクトグラム,象形
일기예보	天気予報
조금도 틀림없이	きっかり
소유격	生格,属格,所有格
텍스트	本書,本文,テキスト
부러워하는	羨ましい
세탁물	衣服,服,衣類,fuku
발동기커버	ボンネット
니트로글리세린	ニトログリセリン
장미 화원	薔薇園
한결같음	画一性,統一性,普遍性
아스퍼거 증후군	アスペルガー症候群
구상화	映像化,可視化
정상적으로	いつもは,俗,通常,tada,何時も,一般に,日頃,大抵,普通に,ただ,いつも
몰인정	ijiwaru,いじわる,意地悪
토르소	胴,胴体
평화를 위한	平安な,安静な,平和な
읽기쉬운	読みやすい
위험이 따르는	大胆な
여자가수	鳴禽
그로즈니	グロズヌイ
가속도계	加速度計
잘 가(세요)	バイバイ,さようなら,では,またね,じゃ、また,バイ,おねんね
구세계	旧世界
유감스럽게도	ainiku,残念,生憎
한 다발	帆環
속이다	1. ペテンに掛ける 2. ばかす,bakasu 3. 犠牲,生け贄 4. 欺く,騙す 5. 嘘をつく 6. 嘘をつく 7. 誑す,丸め込む,強請る 8. 不義をする
식물 인간	野菜,緑黄色野菜
동지나해	東シナ海
항히스타민제	抗ヒスタミン剤
넝마를 걸친 사람	かかし
할당하다	取り置く,配置する
집합론을	集合論
작은 구멍이 많은	多孔質
수동태	受動態,受身形
텅스텐	タングステン
소아의	幼稚
모직물	きじ,切れ,布
몽유병	睡眠時遊行症
업무용명함	めいし,名刺,meishi
급격한	1. 突然 2. 突然 3. 突如な,突然 4. 突然 5. 突然
동성애자	どうせいあいしゃ
시가전차	ライトレール,路面電車,トロリーバス
브래지어	ブラ,ブラジャー
경험론	経験論
적외선의	赤外
무력화	無力化
프랑스의 철학자	パスカル
행성간의	惑星間の
구두를 벗고	ストッキング
가운데 손가락	中指
콩고 공화국	1. コンゴ民主共和国,コンゴ民主共和国（旧ザイール）,ザイール,コンゴ共和国,コンゴ民主共和国 (キンシャサ) 2. コンゴ共和国
성탄절	クリスマス
세탁기	洗濯機
감정이입	以心伝心,人情
속옷류	shitagi,したぎ,下着
하와이어	1. ハワイ語 2. ハワイ語
토론토	トロント
무른모	プログラム,ソフト,ソフトウェア,ソフトウエア
로스토프	ロストフ・ナ・ドヌ,ロストフ
구리 그릇 제조인	銅細工人
작은물방울	小滴
밥을 대다	ある,いる
문법위반	文法違反
소아과	1. 小児科医 2. 小児科学,小児科
숙달한	得意,巧妙な,上手
속을 터놓지 않는	口堅い,口が堅い
휘수연정광	モリブデン
버팀다리	架台,脚立
비행접시	未確認飛行物体,UFO
술시중꾼	ガニメデ
귀마개	耳栓
수도원	1. 修道院 2. 修道院
엉터리 치료	経験論,偽医療
목요일	mokuyōbi,木曜日
메토끼	野兎,ノウサギ
7각형	ななかっけい,七角形
그랜드 피아노	グランドピアノ
메탄올	メタノール
타란텔라 무곡	タランテラ
모으다	集める
9각형	九角形
수도사	にゅうどう,坊さん,僧侶,修道士,入道,僧,nyūdō
탐험가	探検家
허리고기	ロース肉,サーロイン
쇄빙선	砕氷船
5각형	五角形
캠프지정지	キャンプ場,野営地,テント場
재지 않는	1. はかない 2. はかない,hakanai,儚い,儚い (はかない) 3. 短命な,はかない,束の間の
합법으로 인정하다	合法化する
6각형	六角形,ろっかっけい
수동의	受け身,受動的
눈보라	暴風雪,吹雪
모험적인	危険な
집합명사	集合名詞,集合名
분비를 촉진하는	口堅い,口が堅い
논리의 적정	論理学
웬일인지	なぜか
단단한 비스킷	プレッツェル
반드러워지다	さらさら,さらさらと,つるつる
뇌수종	水頭症
한계결정	国境,エッジ
콜리스틴	円形劇場
바르셀로나	バルセロナ市,バルセロナ
물떼새	千鳥
목적격	対格,目的格
지독히 나쁜	極端な
유성음의	有声
토마토	1. トマト 2. トマト
응답하다	返事する,返信,応答する,返信する,答える
광천수	ミネラルウォーター
계획적인	意識的な
게르마늄	ゲルマニウム
바보같이	へらへら
바보같은	すっとこどっこい (suttokodokkoi)
사적 음운론	音韻学,音韻論
전전긍긍하는	パニック状態
구세주	救世主
美國英語	米英語,アメリカ英語,米語
사망자 수	死亡者,死者
수도교	用水路
외상 통장	通帳
묘목상	庭師
서식동물	隣人,お隣
워드 프로세서	ワードプロセッサ,ワープロ,ワープロソフト
회중전등	ランタン,提灯
어딘가에	どこかに
처음부터	本来
계획된	作為的な,意識的な
정신 레벨	精神レベル
젠 체하는 사람	ふくろう,梟,フクロウ
영웅적 행위	男気,勇気
술집의 여급	ウエーター
수류탄	1. ざくろ,榴弾,グレネード,りゅう弾 2. 手投げ弾,手榴弾
독일산 검은 포도	ハンブルグ,ハンブルク
기계학	力学
교향악단	交響楽団,交響曲
세포학	細胞学
고집하는	断定的な
구아바	グアバ,グアヴァ
무대의	風光明媚
기관총	機関銃
근대화	きんだいか,近代化
테이블	1. テーブル 2. テーブル 3. 食卓,机,テーブル,キッチンテーブル 4. テーブル
요술쟁이	魔人,まじん,魔法使い,majin
자기성이 있는	1. 磁気 2. 惹きつける,磁気 3. 磁気 4. 磁気
송전선	電線,電気コード
꾸민 이야기	伝説,神話
고혈압	高血圧
라이베리아	リベリア
하드 디스크	ハードディスク
투계장	操縦席
에우리피테스	エウリピデス
예수의 재림	降臨節
모래통 모래놀이통	砂場,サンドボックス
무도장	舞踏場
노인학	老人学,老人医学
솔직한	単刀直入,tantōchokunyū,たんとうちょくにゅう
재가 되게 하다	焼却する
미국영어	米英語,アメリカ英語,米語
초목이 없는	裸の,裸
수막염	髄膜炎
구차한 억지 이론	詭弁
극도록	1. 極めて 2. 随分,極端に,極度に,いと
정 자	キオスク
2개군	二和音
놀잇간	芝居小屋,こや,小屋
제3기	3次的な,3番目の
무도실	舞踏場
수메르	シュメール語,スメル人
재정하다	裁決する
눈이 맑은	明敏
천도 복숭아	ネクタリン
소집병	徴集兵
저속한 라틴어	一般ラテン語
아메리카 사자	ピューマ
수력학	水力学
소중한	重要
중국의 거룻배	サンパン,三板
아순시온	アスンシオン
굉장한	有名に
날이 넓은 큰칼	マチェテ
굉장히	凄く
태양 에너지	太陽エネルギー
4각형	しかっけい,四角形
세포막	細胞膜
물이 스며든	浸水した
수령초	赤紫色,ホクシャ,フクシャ
태평양	太平洋
한창인 때	高潮
메탄계	アルカン,パラフィン
북아일랜드	北アイルランド
로마제국	ローマ帝国
고풍의	初期,古風な
벗으로서 사귐	友情,友好,仲良し
7개군	shichi,七
수많다	多数
물을 끌어들임	灌漑
엄지발가락	足指,つま先
킬로리터	立方メートル
궁술가	射手,shashu,しゃしゅ
궤변술	詭弁
순례자	巡礼者
암살단원	ちんぴら
태평한	1. さりげない 2. 平安な,安静な,平和な
목양신	パーン
그렇치만	やはり,しかも,それにもかかわらず,それでも
배설하다	排泄する
세포질	細胞質
척수 회백질염	急性灰白髄炎
녹음기	テープレコーダー
수리남	スリナム
비교해 보면	比較的,比較的に
머큐리	メルクリウス,水星
부르키나파소	ブルキナファソ,オートボルタ
길게 계속되는것	イリアス
넵투늄	ネプツニウム
멍청한	繁雑
토목 공학	土木工学
국유의	国立
모노포닉의	モノ
군용의	軍事的な
킬로미터	キロメートル
모수석	樹状突起
손재주	手相
고소 공포증	高所恐怖症
공학자	工兵,機関士,技術者,こうへい,エンジニア,技師
군의관	外科医
비지구의	発破,揮発性
선홍색	ゼラニウム
석회암	石灰石,石灰岩
비난하는	批難,非難
비난하다	1. 叫ぶ 2. 批評する 3. 問う,弾劾する
니트 웨어	編み物
석회석	石灰石,石灰岩
아량이 없음	不寛容
국외자	異人,外人,外国人,がいこくじん
사내다운	otokorashii,男らしい,おとこらしい
딱딱한 사람	スノッブ
성적증명서	認証
홍콩, 중국 특별행정구	中華人民共和国香港特別行政区,香港,ホンコン
전 조	縁起
기꺼이	進んで,快く
고아 주	ゴア,ゴア州
반응 장치	原子炉,反応器
군용기	軍用機
위반행위	侵害
아스베스토증	石綿症
카네이션	カーネーション
방향 지시기	方向指示器
무능력	不可
모스크	モスク
소유주	もち,保持
영국서부의 도시	マンチェスター
전염성 단핵세포층	伝染性単核球症
소유자	持ち主
구역질	吐き気
보네르 섬	ボネール島
네팔어	1. ネパール語 2. ネパール語
비뇨과학	泌尿器科学,泌尿器科
네팔의	ネパールの
녹주석	緑柱石
포트워스	フォートワース
북,드럼	電池
지빠귀류의 새	マネシツグミ
사냥개지기	狩人,ハンター
카카오열매	カカオ
따뜻한 우정	こんせつ,konsetsu,懇切
속임의	欺瞞的な
신앙심이 깊은	敬虔,宗教にかこつけた,信心深い,敬虔な
비뇨기과	泌尿器科学,泌尿器科
기계 언어	プログラミング言語,計算機言語
대수도원장	掌院,僧正
성마른	怒りっぽい
눈의 망막	網膜
메가바이트	メガバイト
프렌들리 제도	トンガ
펠리컨	ペリカン
중생대	中生代
성매매	淫売,売春,baishun,買春,切り売り主義
사진사	撮影者,写真師,写真家
휩쓸어넣다	巻き込む
가슴아픈	悲しい,悲惨な
쾌히 받아들이다	親切に
끌어내다	起こす
페세타 은화	ペセタ
인과관계	因果関係
은방울꽃	スズラン
세발 자전거	三輪車
보통의 필기법	草書
육상경기	運動競技
영이되다	消える
미국서부의 주	ネバダ
살구 버섯	アンズタケ
파찰음	破擦音
송곳니	犬歯,けんし
사진첩	arubamu,アルバム
거침 없이 흐르는	金持,金持の,富有な,裕福,富有,裕福な,豊か
모래 거푸집	砂場,サンドボックス
송골매	1. たか,taka,隼,ハヤブサ 2. 隼,ハヤブサ
멕시코시티	メキシコ,メキシコ市,墨西哥
선박의	航海
동소체의	同素体
온대성저기압	サイクロン
꽃다발	ブーケ
성명서	檄文,檄
솟구멍	泉門
모래주머니	砂のう,破砕胃,砂肝,砂袋
동성애 공포증	同性恋恐惧症
버림받은사람	hinin,ひにん
자격이 있는	できる
새 환경 순응	順応,適応
송과선	松果体
음료수 통	うわさ,噂
티타늄	チタン,チタニウム
모리타니	モーリタニア
금 세공인	金細工人
내재하는	絶対の
포옹하다	立ち込める
증기욕	サウナ,蒸し風呂
셀로판	セロファン
아홀로틀	ウーパールーパー,アホロートル
사시나무속	1. ポプラ 2. ポプラ 3. ポプラ
세면대	洗面器
티크재	チーク
기하적인	1. 幾何学的な 2. 幾何学的な
조지아 주	グルジア,ジョージア
스케이트장	ケートリンク,ローラスケート場,銀盤
완성된 품	手工芸,手腕
항공부대	空軍,airy
완곡어법	婉曲法,婉曲表現
회전목마	メリーゴーラウンド,カルーセル
성문법	法制化,法制,法規,成文法
채식주의자	草食,菜食主義者
궤도에 진입시킴	ちゅうにゅう,chūnyū
음소 하나	音韻,音素
우즈베키스탄	ウズベキスタン
주목할만한	顕著な
세면소	かわや,手洗い,お手洗い,べんじょ,洗面所,厠,便所,化粧室,憚り
경영자측	行政,管理
허풍을 떨다	誇張する,誇張
거친목소리의	有声
장수말벌	はち,蜂
주식물	パン,pan
섣부른	不器用な,ぎごちない
휴대 전화	携帯,けいたいでんわ,携帯電話,セルフォン,ケータイ,セルホーン
하인 우두머리	バトラー
송금액	そうきん
얼룩빼는 약	ターミネータ,明暗境界線,終端器,ターミネーター
색전증	塞栓
걱정거리	心尽くし,こころづかい
쓸모없는	無用な,不用な,無駄な
나미비아	ナミビア
북두 칠성	北斗七星
실레지아직	シレジア
페르뮴	フェルミウム
금홍석	金紅石
전제정치	独裁政治
페르미	フェルミ
주석산	酒石酸
삼지창	トリアイナ
입에 당기는	さらさら,さらさらと,つるつる
부동의 단정	否決
강제적인	強制的な
광포한 행동	激烈
메인프레임	メインフレーム
세인트크리스토퍼 네비스	セントキッツ・ネイビス,セントクリストファー・ネイビス
부동 중심	真中
통계 역학	統計力学
파라과이	パラグアイ
사촌간	いとこ,従兄弟,従姉妹
데이터베이스	データベース
학생 피교육자	学生,在学生,生徒
결함사회	ディストピア
주류판매점	酒店
기화가스	蒸気,湯気,気体
조모하다	笑う,笑い飛ばす,一笑に付す
성명축일	聖名祝日
미국 남서부의 주	ニューメキシコ
신기료 장수	妖婦,妖女,ファム・ファタル
삼중수소	トリチウム,三重水素
주수기	スポイト,注射器
항공모함	航空母艦
미국북서부의 주	アイダホ州
새 고안물	機器,小物,こもの
周期律表	周期表
특수 전문 학교	大學,学園,大学,学寮,単科大学
...와 결혼하다	1. 結婚する 2. 結婚,結婚する
퍼붓다	嘔吐する,嘔吐,吐く
고립주의	孤立主義
토우쿄우	帝都,とうきょう,Azabu,東京
자양분이 많은	栄養素
과거분사	過去分詞
돌출한 가장자리	ゴング
귀에 거슬리게	ぐらい,先ず,およそ,約
유대 여자	ユダヤ人
집진 장치	サイクロン
복잡한 것	複雑さ
우체국 놀이	ゆうびんきょく,yūbinkyoku
주사기	スポイト,注射器
갑상선종	甲状腺腫
일산화탄소	一酸化炭素
왼손잡이	サウスポー
사춘기	思春期,破瓜,青春期
최후의 거점	城塞
속눈썹	睫,睫毛
성직 수임식 규범	序数詞
무조직의	アモルファス
슬픔엘 잠긴	悲しい
바이에른	バイエルン,バイエルン州
달마티아	ダルマチア
흐림이 있는	くもり,(kumori)
생육지	生息地,棲息地
바이올린	ヴァイオリン,バイオリン
카리에스	虫歯,う食
울트라머린	ウルトラマリン
유작ㅇ로서	死後
준사관	じゅんい
다큐멘터리 드라마	ドキュメンタリー
깃털공	羽根つき,羽根
원수 갚기	復習
인플루엔자	流行性感冒,ryūkōseikanbō,りゅうこうせいかんぼう,infuruenza,インフルエンザ
파인트	パイント
성미 까다로운	怒りっぽい,不機嫌な
관료적 형식주의	繁文縟礼,レッドテープ
파이프	運河,キセル,パイプ
갈색을 띤	茶色い
시가 전차	ライトレール,路面電車,トロリーバス
몬트세랫	モントセラト島,モンセラト,モントセラト
성목요일	聖木曜日
유대교 회당	仮庵,幕屋,シナゴーグ
들어주다	聞く
공상과학소설	フィクション,空想科学小説,サイエンスフィクション
파장의	ウエーブのかかった,くねくねした
집정정부시대	領事館,りょうじかん,ryōjikan
두번째의	中古
색소폰	1. サキソフォン 2. サクソフォン,サキソフォン
자라투스트라교	ゾロアスター教
찬성하다	同意する
편도선	扁桃腺
선량한	よい
소가곡	小唄,こうた
페로 제도	フェロー諸島
카망베르	カマンベール,カマンベールチーズ
서로의	互い
단구 증가증	伝染性単核球症
게을리 하다	切り捨てる
밀리미크론	ナノメートル
안장 없는 말의	禿げ
세디유	セディーユ
살아서	生きている
카리스마	教祖的指導力
페로몬	フェロモン
라고스	ラゴス
가솔린 기관	ガソリンエンジン
보고문체	記事,ルポルタージュ
생산자	製作者,生産者
그러므로	したがって
멀리 떨어져 있음	除去
딱따구리	キツツキ,啄木鳥
스코틀랜드의 사람	スコットランド人
상사성 원소	ポロニウム
과달카날 섬	ガダルカナル島
재시동한 위하여	再起動する,リブートする
포그롬	ポグロム
사용성	ユーザビリティ
즐겁게	うれしく,運良く,楽しく,ureshiku
엷은 자주빛	ニオイムラサキ,ヘリオトロープ,薄紫,キダチルリソウ
원생생물	原生生物
섬뜩한	身の毛もよだつ
사육제	カーニバル,謝肉祭
즐거운	1. 幸福な 2. 可笑しい
지뢰 공병	坑夫
정보처리	情報学
편두통	片頭痛,偏頭痛
예언하다	予見,予言する
남극대륙	南極,南極大陸
석류석	ガーネット
생각해 내다	覚える,思い出す
세째아들	マシュー
태양 흑점	太陽黒点
...하게끔 되어	作為的な,意識的な
완전한것	整数
무뚝뚝하게	突然
노력하다	努力する
음운 조직	音韻学,音韻論
작은 곰자리	こぐま座
갈지자로	雁木,ジグザグ
걸친 것이 없는	裸の,裸
오하이오	オハイオ
소광법	煆焼
중립화	中和
영구동토	永久凍土
마음에 품음	興,娯楽
칼라브리아	カラブリア州
기피자	挑戦者
롤드 오트	オートミール
뉴욕 시티	ニューヨーク州,ニューヨーク市,ニューヨーク,紐育
속간표	束桿
생석회	石灰
생선회	さしみ,刺し,刺身
엄하게 심문하다	炙る
상업가	商業
사장석	斜長石
이스터 에그	イースター・エッグ
사절단	大使館
순회 판매인	ryojin,tabibito,旅人,りょじん,たびびと,tabinin,たびにん
기하학	幾何学,幾何
준보석	宝石
야생 생물	野生生物,野生動物
좀체로	稀に
석면증	石綿症
이교도임	ペイガニズム
기형물	人工流産,妊娠中絶,中絶,人工妊娠中絶
삼엽충	三葉虫
칭찬하는	無料
바그다드	バグダード
자격이 업는	むしかく
고유저항	インピーダンス,電気抵抗,抵抗
상아탑	象牙の塔
좋은 결과의	幸運な,成功した,成功裏の
좀처럼	稀に
칭찬하다	褒める,歓迎する
관계 대명사	関係代名詞
기필코	必ず,zehi,正に,是非,その通り,屹度,実に,確かに,確実に,きっと,ぜひ
사전의	1. 語彙的な 2. 語彙的な
상완골	上腕骨
고딕 건축의	ゴシック式の
색안경	サングラス
요리 나르는 쟁반	ウエーター,ウエイター
집게손가락	人差し指
순식간에	さっさと
세례명	名前
아프리칸스어	アフリカーンス語
암페타인	アンフェタミン
말 많은	おしゃべり好きな
붉은 포도주빛	wain,ワイン,葡萄酒
거짓말 같이	凄く
압력가마	オートクレーブ
조총대	銃殺刑執行隊,銃殺隊
페샤와르	ペシャーワル
다량의 흐름	かわ,川
블라우스	ブラウス
순환 논법	あくじゅんかん,akujunkan
금권주의자	スノッブ
살인자	人殺し,暗殺者
그릇된 처리	失態
사전학	辞書編集,辞書学
볼리우드	ボリウッド
트럼프 패	カード,カルテ,札,トランプ,トランプ・カルタ,カルタ
동포애의	情け深い,慈善の,博愛の
셀레늄	セレン
셀러리	1. セロリ 2. セロリ 3. セロリ 4. セロリ 5. セロリ
우중충충한	悲しい,かなしい
삽입사	挿入辞,接中辞
주방장	シェフ,コック,料理人,クック,調理師,りょうりにん
마오쩌둥주의	毛沢東思想
기분내키는대로의	任意,不特定多数
삼두정치	三頭政治
재삼재사	しばしば
흩뿌려 뒤덮다	散らす,ばら撒く
속기사	syoki）,書記
서인도산의향료	オールスパイス
선명함	聞こえ
기호학	記号学
부상하기 쉬운	脆い,脆弱な,傷つきやすい
사진기	カメラ,写真器,kamera,写真機
카카오 나무	カカオ
보통이아닌	非凡
파일명	ファイル名
황소 싸움	闘牛
선명한	senretsu na,鮮烈な,せんれつな
친한 친구	いとこ,従兄弟,従姉妹
콜리플라워	カリフラワー
짐을 풀다	降ろす
사팔눈	斜視
바이칼호	バイカル
상쾌한	爽やかな
건방진 녀석	青二才
드라이아이스	ドライアイス
콜로라도	コロラド州
중성자성	中性子星
기네비쏘	ギニアビサウ
찐득거리는 것	スライム,ぬめり
소라게	ヤドカリ
사투리	方言,ほうげん,訛り
마호가니	1. マホガニー 2. マホガニー
보리피리	オートムギ
운동 에너지	運動エネルギー
모순된 설	逆説,矛盾
기침하다	咳をする,咳払いをする
자주 가는 사람	顧客
우호적인	親切な
무신론자	無神論者
기묘한 장치	機器,小物,こもの
식탁용 나이프	ナイフ
다듬어 연마하다	磨く
순번 명부	順番待ちの名簿
상태의	常態,正常
전기 장치의	シビレる,エレクトリック,電気的な,電動の
진달래	ツツジ,つつじ
선언서	檄文,檄
신성한 의무	神聖
부당하게	1. 無暗に 2. 無暗に
제한 없는	むしかく
라틴 문자	ラテン文字,ローマ字
패스너	ファスナー,ジッパー
화재 경보기	火災警報,火災警報機
서양배	梨,梨の実
찜질하다	醸成する
해바라기	ひまわり,ヒマワリ,向日葵
고스란한 이익	ベルベット
미식축구	1. アメリカンフットボール,サッカー,アメフト 2. アメリカンフットボール,アメフト
획득하다	える,得る,手に入れる,買う,成し遂げる
서예가	書家,書道家
공군기지	空軍基地
모래 벼룩	スナノミ
미확인 비행 물체	未確認飛行物体,UFO
중이염	中耳炎
등방성의	等方的
옥시던트	オキシダント,酸化剤
식도락가	美食家,料理通,グルメ,食通
플로지스톤	フロギストン
칠칠치 못한 계집	売春婦
중재인	レフリー
파트로네	カセット
성체 용기	聖骨箱
지능 지수	知能指数
오토자이로	ヘリコプター
미시 경제학	ミクロ経済学
동정의 말	哀悼,悔やみ
성악가	歌手
뜻밖의	igai na,いがいな,意外な,にわか
보고문학	記事,ルポルタージュ
뜻밖에	突然
기운나게 하는	爽やかな
문란한 행위	文法違反
지각없는	軽率
보강하다	補強
주지사	知事
항공 서한	航空書簡
사프란	1. サフラン 2. サフラン 3. サフラン 4. サフラン
중요한	1. 大事に,daiji ni,だいじに 2. 大事に,daiji ni,だいじに
옴에 걸린	痒い
따돌리다	嫌う,憎む,いやである
물론이죠	必ず,zehi,正に,是非,その通り,屹度,実に,確かに,確実に,きっと,ぜひ
팥빛의	あずき色
자이언트 팬더	パンダ
소리는	欺瞞的な
도미니카	ドミニカ国,ドミニカ,Dominika,どみにか
솔로몬	ソロモン
발트 해	バルト海
성애의	ero
서정시	ライアー
중요도	大きさ
선인장	シャボテン,サボテン,仙人掌
스헬더 강	スヘルデ川
항생물질약	ペニシリン
사향소	ジャコウウシ
소원해진	疎い
진부한 표현	決まり文句
덴마크종의 큰 개	gurēto dēn,グレート・デーン
파시즘	ファシズム,ナチズム
석유황	硫黄色,硫黄
성급하게	きゅうきょ
성양배	梨,梨の実
볼펜의 일종	ボールペン
엘리트 지배층	能力主義
삿포로	札幌
플랑크 상수	プランク定数
장례행렬	葬式,葬儀
그리스의 수학자	エウクレイデス,ユークリッド
위선을 부림	偽善者,ぎぜんしゃ,gizensha
비굴한 사람	おべっか使い
착란시키다	気をそらす
선원의	航海
전략폭격의	戦略的な
고대 라틴말	古ラテン語
회의주의	かいぎ
소리의	有声
함부르크	ハンブルグ,ハンブルク
브리스틀 해협	ブリストル海峡
카탈로니아어	カタルーニャ語
미국 국방성	五角形
요약한 위하여	要約する
파스칼	パスカル
서임자	とうしか,出資者,投資家,しゅっししゃ
프레리 도그	プレーリードッグ
벼락 맞은	呆然,口あんぐり
기묘한사람	変な人
매스꺼움	吐き気
跆拳道	格闘技,テコンドー
지난날	旧来,かつて
성별이없는	無性の
종형제	いとこ,従兄弟,従姉妹
소다회	sōda,ソーダ
알루미나	アルミナ,酸化アルミニウム
이테르븀	イッテルビウム
알루미늄	アルミニウム
미국북동부의 주	ニューヘンプシャー
속도계	速度計
사우스다코타	サウスダコタ
아마빛의	亜麻
달라이 라마	ダライ・ラマ
앙 갚음	ふっきゅう,復習
바르는 물약	ローション,化粧水
벙어리의	黙々
수상 비행기	水上機,すいじょうき
유죄를 선고하다	懲罰する,ばっする,制裁する
인공위성이름	探検家
방사성 붕괴	放射能
포인세티아	ポインセチア
중성자 폭탄	中性子爆弾
적절한 표현	幸い,幸せ
종행면	メソン,メゾン
포도 주스	グレープジュース
몰리브덴	モリブデン
요구르트	ヨーグルト
알코올 중독자	酒飲み,愛飲家,アルコール中毒者,飲んべえ,小虎,飲兵衛,辛党,飲んだくれ
죽이다	1. 終える,終了する 2. 壊す 3. 謀殺する,殺害する,殺す
주유소	ガソリンスタンド,gasoline stand
무능력하게 하다	無効にする,無力化する
눈썹 연필	まゆペン
제성절의 전야	ハロウィン,ハロウィーン
파손물	片輪
공설도축장	屠場,食肉処理場
향토무용	フォークダンス
로스토프나도누	ロストフ・ナ・ドヌ,ロストフ
감정하다	批評する
선사학	先史時代
최하층민	hinin,ひにん
주야평분시	1. 分点 2. 分点
속임수의	操作的
염소 수염	シソ,山羊髭
라디안	弧度,ラジアン
돌팔이 의사	サフラン
살충제	殺虫剤
극한정책	瀬戸際政策
인지를 초월한	問題外,信じられない,問題にならない
업신여기다	しゃみをする,くしゃみをする
벨라루스어	ベラルーシ人,ベラルーシ語
상반신부	ブーケ
월경하다	月経がある
모닝코트	燕尾服
소도시	町,都市,街,村
감자잎 벌레	コロラドハムシ
혼자 우쭐대는	ひとりよがりの
팔변형	八角形,八角,はちかっけい
티셔츠	ティーシャツ,Tシャツ,Ｔシャツ
살쾡이	ピューマ,山猫
사리에 맞지 않는	盲目
진균류	菌類,きのこ
마감 시간	締切,しめきり
포도 온실	ぶどう園,ブドウ園
기쁜 듯한	嬉しい
사탕무	1. 砂糖大根 2. 甜菜
유괴하다	誘拐する
선술집	酒場
참나무속	かしわ,柏,オーク
예약하다	こう,請う
기병대 기수	トランペット,口琴
바깥 주인	主,持ち主
직교의	1. 直交の,四角い 2. 直交の
중심부	ハブ
더 나쁜	さらに。。。悪い,もっと悪い,いっそう悪い,より悪い
주악석	オーケストラ,ōkesutora
쇠똥구리	糞虫
이제부터	従って,ですから
특제로	1. 特別,特殊に,特別に 2. 特別,一入,ひとしお,別段,特殊に,特別に
여류 조각가	彫刻家
회유하다	なだめる
사탄교	サタニズム
블랙베리	クワの実
소득세	所得税
전차 대원	タンクローリー,油槽船,オイルタンカー,タンカー
남아메리카[남미]	1. 南アメリカ 2. 南米,南アメリカ
핵 입자	かくし,核子
상관관계	相関
지방의 주민들	田舎,田園
박테리아의 단수형	バクテリア,細菌,bakteria,きん
중심가	銀座通り
안심시키는	こころづよい,心強い
포화 채도	飽和
지게차	フォークリフト
중수소	じゅうすいそ,重水素
고인의 유품	遺物,聖遺物
셰리주	シェリー酒,シェリー
아주 작은	chiisana,小さな,ちいさな,小型の
전국민의	国立
산탄총	散弾銃
지겨움	吐き気
지겨운	恐ろしい,憎い
산토끼	野兎,ノウサギ
바람막이 유리	フロントガラス
기하학책	幾何学,幾何
성성이	オランウータン
항공 우편	航空便
혼합 경제	混合経済
카리브 해	カリブ海
확언하다	断言する
성상패	平和
스며 나오다	にじみ出る
볼리비아	ボリビア
스핑크스	1. スフィンクス 2. スフィンクス
2분하는 일	二分法
중소수	じゅうすいそ,重水素
지게미	酒粕
브루나이	ブルネイ
산뜻한 녹색	ピスタチオ
브라질리아	ブラジリア
직각의	直角の
족하다	足りる,足る
카르타고	カルタゴ
닭 둥우리	鶏舎
마이크로네시아	ミクロネシア,ミクロネシア地域
중성자	中性子
중성의	中性
항공 일지	日誌,自動車登録台帳
세숫대야	1. 洗面器 2. 洗面器
위스콘신	ウィスコンシン
일각고래	一角
근지점	近地点
강삭 철도	鋼索鉄道
살루키	サルーキ
선같은	腺状
판에 박은 문구	ステレオタイプ
사리탑	仏舎利塔,ストゥーパ,卒塔婆
살리다	促進する,加速する
뛰어나다	越える,超える
산티아고	サンティアゴ
문절망둑	ハゼ,鯊,沙魚
남지나해	南シナ海
유전하다	継承する,受継ぐ
짙은 황록색	濃黄緑色
급전환	転移 (医学)
베네수엘라	ベネスエラ,ベネズエラ,ヴェネズエラ
아메리카	1. %E3%82%A2%E3%83%A1%E3%83%AA%E3%82%AB%E5%B7%9E,アメリカ州 2. 亜米利加,アメリカ大陸,アメリカ州,アメリカ合衆国,アメリカ,米国
전칭적으로	一般に
부쿠레슈티	ブカレスト
프랑스의 점성학자	ノストラダムス
사모아	1. サモア 2. サモア
사면체	四面体,三角錐
정신 박약자	尾状花序
설계된	意識的な
아나키즘	アナキズム,無政府主義
그쪽에	あそこへ,そこへ
애도의 말	哀悼,悔やみ
금지된	禁じられた,ならない,禁止の
점잔빼는	小刻みな
유아의 돌연사	乳幼児突然死症候群
술집주인	ウエーター
과로케하다	過ぎる
서기관	ジャーナリスト,記者,リポーター,報告者
부드럽고 온화한	女らしい,おんならしい
휴가를 보내다	休みを取る,休暇を取る
을 양자화하다	量子化
라마승	ラマ
발자국을 뒤쫓다	パグ
슬레이트 공	ワラジムシ
힌두스탄어	ヒンドゥスターニー語
강변의 낮은 풀밭	草原
기억하다	記憶する
앨버타 주	アルバータ州
사마귀	イボ
웨이스트	胴回り,ウエスト,胴のくびれ,腰
지배권	優勢
독재 정치	スターリニズム,独裁政治,幕府,bakufu,独裁
사마륨	サマリウム
즉시로	すぐに,直ちに,直ぐに
고약한 냄새 나는	くさい,臭い
배어들게 하다	飽和させる
사료 편찬	史学史
선형계획	線形計画法
호색문학	ポルノグラフィー,猥褻,ポルノ,エーブイ,猥本,アダルトビデオ
로즈메리	ローズマリー
마이크로 초	マイクロ秒
질문서	ankēto,アンケート
지방시	ひょうじゅんじ,標準時間,ひょうじゅんじかん,時
기식자	寄生生物
사망률	死亡率
필적 관상법	筆跡学
아메리슘	アメリシウム
깨끗이 하는 사람	デバッガ
즉시의	さっさと
지배인	管理者,支配人,ディレクター
짐승 같은 놈들	家畜,うし,牛
키릴 문자	キリル文字
베네치안 블라인드	ブラインド
입학 허가	入校,にゅうがく,nyūkō,nyūgaku,入学,にゅうこう
근자의	後者
작은 관목숲	雑木林
도덕관념	良心
어두음 첨가	義肢
판매원	1. 店員 2. 店員
카슈미르	カシミール,ジャンムー・カシミール州
신자유주의	新自由主義
간첩을 씀	スパイ行為
소읏앞온어	スーザフォン,チューバ
아주 싫은	憎い
기소자	検察,検察官
미국 중앙의 주	カンザス州
팔리어	パーリ語
조선대의 쐐기	雛形
금요일	きんようび,金曜日,kin'yōbi
근절자	ターミネータ,明暗境界線,終端器,ターミネーター
심술궂게	それどころか
중탄산나트륨	重曹
간섭하는	おせっかい
양막천자	羊水検査
간섭하다	よちよち歩く,よたよた歩く
일광 반사기	ニオイムラサキ,ヘリオトロープ,薄紫,キダチルリソウ
아나콘다	アナコンダ
기수사	集合数,基数
티브이	テレビ
사방형	菱形,斜方形
진료소	病院
최루 물질	催涙ガス
지불할만한	安い,手ごろな
물이많은	水っぽい
쾌락주의	快楽主義
기술의	マジック
플루오르	フッ素
플루오린	フッ素
라미아	吸血鬼,ヴァンパイア,ラミアー
까불다	浮かれ騒ぐ
무리없이	勿論,もちろん,当然
그재목	イエティー
마요네즈	マヨネーズ
씨족 집단	家族
경외전의	うその,典拠が疑わしい
심술궂은	怒りっぽい,不機嫌な
팔레트	パレット
거짓 맹세	偽証の罪
전파 천문학	電波天文学
내려받다	ダウンロードする
마카로니	マカロニ
똥살 놈	うすのろ,でくのぼう
극작술	劇場
상류로	川上
백랍제의 기물	しろめ
지르콘	ジルコン
티베트	チベット自治区,チベット,西蔵
서기소	表意文字
보스니아 헤르체고비나	ボスニア・ヘルツェゴビナ,ボスニア,ボスニア・ヘルツェゴヴィナ,ユーゴスラヴィア,ユーゴスラビア
악마주의	サタニズム
라바트	ラバト
대량학살	集団虐殺,ジェノサイド,大虐殺
오래 끈	長い,ながい,nagai
옳지 않은	不正,不当な
우발사건	成功報酬
꺼내다	開く
샐러드	サラダ
범절 있게	そっと
상업 중심지	デパート
외과 의사	外科医
파르페	パフェ (pafe)
지리학	地理学,地理,chiri
설교자	说教者
기생충	虫螻
샐러리	セロリ
무함마드 (Muhammadeu)	ムハンマド (Muhanmado)
삼림지	森林,しん
새로운	最近,新しい
상하이 시	上海,上海市
섬광등	1. ランタン,提灯 2. 稲光,フラッシュ
근일점	近日点
기상학	気象学
지멘스	ジーメンス
사미어	1. サーミ語 2. サーミ語
상륙장	ガート
특수형	亜熱帯
인종차별정책	アパルトヘイド,アパルトヘイト
팔라우	パラオ
자기 중심벽	自惚,己惚
트로츠키주의	トロツキズム
극피동물	刺皮動物,棘皮動物
판례법	1. 慣習法 2. 慣習法
레가토	レガート
체르노빌	チェルノブイリ,チョルノーブィリ
일부분은	一部,部分的に
시아파 사람	シーア
과격주의	集産主義
상당히	1. 比較的,比較的に 2. 中々,実質的に,なかなか
자유주의화	yunyūjiyūka,ゆにゅうじゆうか,輸入自由化
우주비행술	宇宙航行学
야쿠트 말	サハ語
우주비행사	宇宙飛行士
투표소	投票所
너그러이	多く,一応
아스피린	アセチルサリチル酸,アスピリン
葡萄酒	wain,ワイン,葡萄酒
불쾌한사람	迷惑,厄介者
연안경비대	沿岸警備隊
서양지치	ルリジサ
지랄병	てんかん,癲癇
퉁명스럽게	突然
기중기	エレベーター,昇降機
암살하다	暗殺する,殺す
팔라펠	ファラフェル
현금 자동 지급기	エーティーエム,現金自動預け払い機,自動窓口機,自動現金預払機,ATM
수입 후보	カーペットバッガー
꿰매기장식	裁縫
현장 부재 증명	アリバイ
온난전선	温暖前線
진심으로	切実に
하도급 계약자	サブコン
꼭들어 맞는	必至の,恒常的,避けがたい,常習,避けることのできない,必至,不可避
이슬람교의	イスラム教の
지렛목	支点
표의 문자	表意文字,指事,いじ
천문학자	天文学者
상대방	aite,相手
통속 라틴어	一般ラテン語
파라솔	傘,かさ,kasa,パラソル
작은 비행장	飛行場
뾰족한 끝이 없는	頭が悪い
쇄석포도	アスファルト舗装路,ターマック
우눈쿼듐	ウンウンクアジウム
지평선의	横の,横,水平な,水平
1프랑화폐	フラン
지구라트	ジッグラト
일각 고래	一角
다소 신맛이 있는	酸性の
회교문화	回教
이에 반하여	それどころか
고유명사	名前,固有名詞
사바 섬	サバ島
언제나의	いつもの,tada,ただ
기자석	記者席
양륙하다	上陸する
꼭들어 맞음	蟻継ぎ
유기체의	有機
지령서	ディレクトリ
지렁이	蚯蚓,ミミズ
매우 기쁜	楽しい,たのしい,美味しい,tanoshii
팔라듐	パラジウム
항로 표지	とうだい,灯台
지라프	麒麟,ジラフ,キリン
기저귀	襁褓,お襁褓,おむつ
상담역	顧問
마요라나	マジョラム,オレガノ
방송된 게임	放映されたゲーム
여자용 머리 띠	ブラ,ブラジャー
산뜻한	涼しい,すずしい
공황적인	恐怖
기아픽	アグーチ
동시발생	共時性
신어의 사용	新語
벼룩시장	市場,蚤の市,古物市,フリーマーケット
경기 대회	1. トーナメント 2. トーナメント 3. トーナメント 4. トーナメント
진드기	ダニ
매우 급히	きゅうきょ
우눈트륨	ウンウントリウム
운용 과학	オペレーションズ・リサーチ
경찰 국가	警察国家
식별력을 요하는	快い
상등품	ヒナギク
러크나우	ラクナウ
골짜기 비슷한 것	たに,谷,tani
실제에 어두운	非実際的
팽나무	エノキ
살라미	サラミ
작자 불명의 저작	筆名,雅号,ペンネーム
증류액	蒸留
벵갈루루	バンガロール
콜롬비아	コロンビア
고대이집트학	エジプト学
과달라하라	グアダラハラ
순수하게	綺麗に
태국의 화폐단위	バーツ
증류법	蒸留
세족 목요일	聖木曜日
증류물	蒸留
임종의 방	ガス室
기울다	1. 傾く 2. 曲る
흩뿌리다	散らす,ばら撒く
쿠알라룸푸르	クアラルンプール
몰래 말하다	囁く
아시가바트	アシガバート
상호의 영향	対応
사랑니	親知らず
꾼 사람	借方,債務者
기압계	晴雨計,気圧計
재생하다	リサイクルする
기악가	選手,音楽家
슬라브어의	スラブ人,スラヴ人
무지개송어	マス,虹鱒,ニジマス,鱒,(masu)
켄타우루스	ケンタウルス族,ケンタウロス
어의 발달론	意味論
이해 관계가 없음	ニュートラル
기억력	kioku,記憶,きおく
트란실바니아	トランシルヴァニア
온실 효과	温室効果
월권행위	おうしゅう,押収,ōshū
아우구스투스	アウグストゥス
낭심보호대	jokkusutorappu,ジョックストラップ
게시하다	張り紙,ポスター
여 가장제 사회	家母長制
늘 가는 곳	裏庭
레나강	レナ,レナ川
기업가	冒険家,企業家
곱사등이	傴僂
견적하다	批評する
베오그라드	ベオグラード
인정 없는	迂闊な
납득시키다	自覚,自覚させる,納得,納得させる,説得,説得する
사라져	従って,ですから
쪼개는 것	包丁
무익하게	1. 不用に 2. 不用に
시중드는 사람	保護者,係員
교수하다	教える
거울상체	光学異性体
진실성	1. 信用性,真実性 2. 真実性
기여하다	寄付する
품행이 나쁜 여자	売春婦
파두츠	ファドゥーツ
격노하게하다	息巻く,激怒させる
정보 검색	情報検索
선한목자	イエス・キリスト,みこ,イエスキリスト,キリスト
사철 피는	永遠の,永久の,永遠
선원 생활	水兵,船員,ジャック,水夫
연장 시간	延長戦
평판 있는것	諺,ことわざ,格言
절대 영도	絶対零度
질문하다	質問する
아스파라긴	asuparagin
작은 부젓가락	牧師
진실의	切実に
극악 무도	サタニズム
스케이트보드	スケートボード
일자 일웅	一夫一婦
벨루오리존치	ベロオリゾンテ
사실상	実は,実際には
화학 공학	化学工学
샐비어	セージ
샤미센	さんせん,三味線,三曲,三味
세르비아	セルビア
악마 연구가	サタニズム
가나의 수도	アックラ,アクラ
아스타나	アスタナ
아일랜드 공화국	アイルランド
중앙 아메리카	中米,中央アメリカ
편파적으로	一部,部分的に
레몬그래스	レモングラス
재미로 하는 것	アミューズメント
서양장기	西洋碁,チェッカー
산성의	酸性の,酸性
파도바	パドヴァ
산성증	酸性症,アシドーシス
코르시카	1. コルシカ島 2. コルシカ島
이야기 잘하는	口語の,口語,話し言葉
절제하는	禁欲
작은 캥거루	ワラビー
네델란드	オランダ
코탄젠트	余接,コタンジェント
질식시키다	1. 窒息させる 2. 窒息させる
산성화	酸性化
분리주의자	分離主義者,分離独立
질식시키는	切ない
고슴도치	1. ハリネズミ 2. ヤマアラシ
판도라	パンドーラー
게걸스레 먹는	熱心な
비디오 게임	コンピューターゲーム,ビデオゲーム,テレビゲーム
우주 비행사	宇宙飛行士
산성비	酸性雨
상투메 프린시페	サントメ・プリンシペ
사생활	ひみつ,秘密,グライバシー
영리주의자	商業
노스트라다무스	ノストラダムス
발표하다	通告,知らせる
절대 온도	ケルビン
세네갈	セネガル
짐싣기	つみに,tsumini,積荷
질식체	消火器
티라나	ティラナ
아스타틴	アスタチン
수중 거주실	生息地,棲息地
바티칸 시국	1. バチカン市国,法王庁,バチカン 2. バチカン市国
생물학	生物学
산사태	山津波
특별히	特別,特別に
사수대	弓道
특별한	1. 特別な 2. 非凡
사업가	冒険家,企業家
출판하다	出版
기증품	寄付
개인주의	1. 個人主義 2. 個人主義
닭의 볼기살	ぼんぼち
위원수탁자	委員会,委員會
진사의	朱色,赤い
지속성	忍耐,堅持
카르나타카	カルナータカ州,カルナータカ
피곤하게 하는	退屈な
베낸 고깃점	ステーキ
신인동형동성설	擬人観,擬人化
지소사	chiisana,小さな,ちいさな,小型の
허리의 잘록한 곳	胴回り,ウエスト,胴のくびれ,腰
고소하다	訴える
위 협	脅迫
긴 겉옷	ドレス,ワンピース
지진 해일	津浪,津波,つなみ
원핵 생물	原核生物
동남아시아	とうなんあじあ,東南アジア,Tōnan-Ajia
크리스토퍼	クリストファー
못 본체함	ハゼ,鯊,沙魚
가보로네	ハボローネ
숙련된 기술	呼吸
악취를 풍기는	くさい,臭い
금고 털이 연장	かんきり,缶切り
안녕하십니까	こんにちは,こんばんは
폭력단원	ちんぴら
그럼에도불구하고	やはり,しかも,それにもかかわらず,それでも
성 차별	性差別
과거완료	過去完了
3인 관리제	三頭政治
동력지레	ニガー,黒いやつ
인도네시아어	インドネシア語
증기 보일러	ボイラー
자연과학	1. 自然科学,物理科学 2. 物理科学
가수분해	加水分解
항성상 천체	クエーサー
학위 논문	論文
음매 음매	牛,雌牛
더욱 더	その上,しかも,その上に,尚且つ,さらに,katsu
집사람	家内,fujin,妻,女子,つま,okusan,奥さん
일산화질소	笑気
상수도	都市インフラ
전무 이사	管理者,支配人,ディレクター
새색시	花嫁,新婦
세대차	:ジェネレーションギャップ
금광;부원	金鉱
길조의	さい先のよい
상수리	ドングリ,団栗,どんぐり,donguri
어이없는	悲しい,かなしい
근친혼	近親婚
상사의	似たような
지소의	chiisana,小さな,ちいさな,小型の
유전적 특징	遺伝学,遺伝的特性
열렬한 애인	ロミオ
군주 정치	君主制
팔꿈치	1. 肘 2. 肘 3. 肘
증오심	存分,憎しみ,憎悪
아스팔트	1. アスファルト 2. アスファルト舗装路,ターマック
가택 구류	自宅軟禁
아파트거주자	穴居人
자연발생론	自然発生説
외국인을 싫어하기	外国人排斥,外国人恐怖症,外国人嫌悪
훅부는 사람	鰒,河豚,フグ
전망이좋은	美しい
라오족	ラオス人,ラオ語,ラオス語
분자 생물학	分子生物学
이탈리아	1. 伊太利亜,伊太利,イタリー,イタリア 2. イタリア
백색 왜성	白色矮星
중학교	1. 中学校 2. 中学校
울려 퍼짐	聞こえ
결코... 안다	何時でも,万々,曾て
라오어	ラーオ語
기운을 돋우는것	wain,ワイン,葡萄酒
에리트리아	エリトリア
라오스	ラオス
특명의	非凡
연체 동물학	軟体動物学
노하게 하다	悪化する
군사 교련	guntai,軍隊,ぐんたい
네덜란드	オランダ
대사부인	大使
말이난 김에	ところで,ちなみに
ㅁㅇ	比較的,比較的に
그레나다	グレナダ
목금의 일종	マリンバ,シロフォン,木琴
성급한	突然
꼼꼼한	精密,正確な,厳密な
파내다	蘇らせる
파나마	1. パナマシティ,パナマ 2. パナマ
공고하다	通告,知らせる
이구아노돈	イグアノドン
소리가 크다	肺,肺臓
그후에	それ,それから,その後,後で
타일랜드어	タイ語
세계화	グローバライゼーション,グローバリゼーション,グローバル化
금하다	禁ずる,禁止する,禁じる
아시아주	アジア
앰뷸런스	救急車
트리튬	トリチウム,三重水素
주황색	オレンジ色
크메르 루주	クメール・ルージュ
프리지어	フリージア
모스크바	モスクワ
중합체	重合体,ポリマー
지어낸 이야기	お伽話,おとぎ話,メルヘン,童話
쓰다듬다	かわいがる,愛撫する,愛撫,なでる
하이에나	ハイエナ
귀족 명감	かぞく
농경학법	農学
착상하다	想像する,そうぞうする
염소 처리법	塩素化
연산방식	アルゴリズム,arugorizumu
동음 이자	同音語
전가하다	任命する
레스토랑	レストラン,食堂
뉴질랜드	1. ニュージーランド 2. ニュージーランド
뜨내기 정치가	カーペットバッガー
소련 정부	クレムリ
서나무	垂,四手
사브르	サーブル
나팔꼴 보청기	補聴器
라자냐	ラザニア
메역취속의 식물	アキノキリンソウ
카페테리아	食堂
튀긴 옥수수	ポップコーン
레바논의 수도	ベイルート
냄새 나는	傲慢な,横柄な,高慢な
가시고기	若者
지상권	主権
성공한	幸運な,成功した,成功裏の
카프리섬	カプリ島
그러니까	従って,ですから
광고 방송	広告
포트오브스페인	ポートオブスペイン
신학설 신학	新語
소리지르다	叫ぶ
안타나나리보	アンタナナリボ
산타클로스	サンタクロース
사변형	中庭,なかにわ
나긋나긋한	軽い
성미에 안 맞는	嫌って
선동가	煽動
밝게 하다	照明する
란제리	ランジェリー
그행사	拒否権
생물상	生物学
포장재료	どうしょう
생명학	生態学
뉘른베르크	ニュルンベルク
확대하다	誇張する,誇張
불굴의 정신	勇気
결합하다	溶接する
생물량	生物量,バイオマス
라이터	可燃物
패배주의	敗北主義
끔찍하게 죽이다	謀殺する,殺害する,殺す
세인트빈센트그레나딘	セントヴィンセントおよびグレナディーン諸島,セントビンセント・グレナディーン諸島
사생아	落胤,ラブチャイルド,私生児
에리트레아	エリトリア
골드코스트	ガーナ,ゴールドコースト
항공우편	航空書簡
지방화	局所化,ローカライゼーション,局在化,地方化
백년 계속되는	世俗の,世俗,非宗教的な,非宗教的,世俗的な
사산아	死産
클레이모어 지뢰	クレイモア
트럼펫	1. トランペット 2. トランペット,口琴
트랙터	トラクター
트랙타	トラクター
이겨내다	壊滅させる,鎮圧する
몬트리올	モントリオール,モントリオー
레닌그라드	ペトログラード,サンクトペテルブルク,レニングラード,セントピーターズバーグ
생물권	生物圏
생물군	生物学
기름에 튀긴	age
트롬본	トロンボーン
나비넥타이	ボウ
섣달그믐날	大晦日
간호사의일	かんご
상비군	陸軍,軍,軍隊
주현절	公現祭
주홍색	くれない,朱,あか,緋色,丹朱
증수회	賄賂
철근 콘크리트	鉄筋コンクリート
말을 더듬다	1. 吃り 2. 吃る,どもり
사파이어	サファイア
그래비톤	重力子
생리학	1. 生理学 2. 生理学
트랜스	変流器,トランスフォーマー,変圧器
큰 천막을 치다	パビリオン
젊은 여자	少女,女の子
강제하다	強要する
코듀로이 양복	コーデュロイ
비파나무	ビワ,枇杷
가공의 사람	伝説,神話
팔각형	八角形,八角,はちかっけい
융합시키다	合同
이문 남겨 팔다	頭皮
수리논리학	数理論理学
태양 신경총	太陽神経叢
연골 조직	軟骨
새벽녘	akegata,暁,夜明け,あけがた,明け方
국제적인	国際的な
벨그라드	ベオグラード
진분수	真分数
영국의수도	ロンドン
에펠 탑	エッフェル塔
지부티	1. ジブチ 2. ジブチ
천천히 들어감	当てこすり
귀뜀;암시;정보	グリフォン
참고서목록	参考文献,しょし,書誌学,書誌,文献目録
찌르는듯한	辛辣です
연필 깎개	鉛筆削り
암스테르담	アムステルダム
란저우	蘭州
세균학	1. 細菌学 2. 細菌学者
대성공의	幸運な,成功した,成功裏の
꽃가루	花粉
깨우다	起こす,目覚める,おきる
유사 분열	体細胞分裂
표정이 풍부한	雄弁な,口八丁な,雄弁,爽やか,三寸な
비실용적인	非実際的
로스앤젤레스	ロサンゼルス
평평한	横の,横,水平な,水平
신청하다	依頼する
재정한	仲介する
전부터	nagaraku,ながらく,長らく
아랍에미리트	アラブ首長国連邦
사라예보	サライェヴォ,サラエヴォ,サラエボ
깨끗하게	綺麗に
당황하게 하는	不可解な
귀족 계급	かぞく
입체파	キュビスム
끌어당기다	引きつける
감독회	教区
다발짓다	束,層
눈물 어린	kasumi
심술 궂은 여자	カタマラン
일층석	オーケストラ,ōkesutora
동질접합체	ホモ接合型
정밀한	精密,正確な,厳密な
자청색	マゼンタ,マジェンタ
비슈케크	ビシュケク
허리의 잘룩한 곳	胴回り,ウエスト,胴のくびれ,腰
오세트어	オセット語
깨끗한물	リンパ液
표시어	類義語,同義語
거의...않다	ぎりぎり
표면상의	表面上
아라비아어	1. アラビア語 2. アラビア語,アラビア人
감독자	警視
고급 주택화	ジェントリフィケーション
어떻게 든지 하여	なぜか
재이용	リサイクル
의미 심장	妊娠,にんしん
흡족하게	順調に
오를레앙 천	オルレアン
홀로코스트	ユダヤ人大虐殺,ホロコースト
빨래집개	洗濯ばさみ
장장한	強壮な
화학 반응기	原子炉,反応器
자연도태	自然淘汰,適者生存
테스토스테론	テストステロン
국제간에	国際的に
무선 전신	ラジオ
사가랴	ゼカリヤ書
완료 분사	過去分詞
입체경	実体鏡
포타슘	カリウム
머릿가죽	頭皮
레몬수	レモネード
셸란 섬	シェラン島
전범위	全域
관청식의	繁文縟礼,レッドテープ
자책골	オウンゴール
레바논	レバノン
... 하자마자	その内,実際に,今
재정인	レフリー
풍부한	1. 金持,金持の,富有な,裕福,富有,裕福な,豊か 2. だいふごう,大富豪,ひゃくまんちょうじゃ,百万長者 3. 豪華な
프로트악티늄	プロトアクチニウム
접미어	接尾辞
수수께끼	謎,nazo
입천장	上顎,口蓋
일치된	連合した
인지(inji)	心得,chishiki,学識,ちしき,認知,こころえ
접미사	接尾辞
푸성귀	野菜,緑黄色野菜
악티늄케이	フランシウム
줄기차게 공격하다	包囲,攻城戦
솔로몬제도	ソロモン諸島
밀실 공포증	閉所恐怖症
이중베일	ヤシュマク
끝내다	1. 中止する 2. 終える,終了する 3. 終わる 4. 切れる,終わる
탄수화물	炭水化物
전능의 신	全能
진보주의	革新
어느덧 지나가는	はかない,hakanai,儚い,儚い (はかない)
결혼의신	処女膜
맑아지다	大便をする,くそをする
중탄산 소다	重曹
비틀배틀	雁木,ジグザグ
동시적인	同じ,同時
불가리아의 수도	ソフィア
노르웨이	諾威,ノルウェー
가로챔	おうしゅう,押収,ōshū
오리야어	オリヤー語
병참 업무	物流,運送,兵站,butsuryū,ぶつりゅう
전위차계	ポテンショメータ
브르타뉴	ブルトン語
가련한	辛辣な,痛切な,痛烈な
가게 주인	商人,shōnin
홋카이도	北海道
응하여	二度と,再び,又,二度,あらためて,再度,もう一度,って
여성에게 어울리는	onnarashii,女らしい,おんならしい
상상 할 수도	問題外,信じられない,問題にならない
브리즈번	ブリスベン
디지털형의	デジタル
산토도밍고	サントドミンゴ
신교 교회	プロテスタント
가로의	横の,横,水平な,水平
최루 가스	催涙ガス
사랑스러운	可愛い,素敵
자메이카	1. ジャマイカ 2. ジャマイカ
대기업가	実業家
기억력 상실	記憶喪失
전성기	正午,jūni-ji,昼,真昼,しょうご,shōgo,十二時,じゅうにじ
사기꾼 같은 짓	経験論,偽医療
가려움	かゆみ
이튿날	午前,翌日
가려운	痒い
자치체	自治体,町,都市
레몬밤	レモンバーム,西洋山薄荷
가로등	gaitō,街灯
천연가스	ガス,市ガス,天然ガス
그릇된 계산	いさん,isan,違算
마드리드	マドリッド,マドリード
노른자위	卵黄,らんおう,黄身
저서명	話題,主題
과떼말라	グアテマラ
인디고틴	インディゴ
벌집의작은구멍	肺胞
간이 식당	1. レストラン,食堂 2. kafe,コーヒーハウス,珈琲,コーヒー店,喫茶店,カフェ
이태리	伊太利亜,伊太利,イタリー,イタリア
프랑스 여자	フランス人
에베레스트	エベレスト,チョモランマ
감람석	橄欖石,カンラン石
꼭 맞게	適当に
대기오염	大気汚染,空気汚染
경상 계정	当座預金
불공평하게	一部,部分的に
염가 수출	投棄
감람암	カンラン岩,橄欖岩
모래 폭풍	sunaarashi,砂嵐,すなあらし
뾰족탑	ミナレット
평범한 이야기	決まり文句
이탄지	コケ,苔
이터븀	イッテルビウム
큰바다오리	大海烏
모험을 즐기는	冒険好きな,冒険的な
나가노	中部,長野
직접 목적어	直接目的語
제비꼬리	アゲハチョウ,agehachō
백파이프	バグパイプ
시계 연구가	oro-rojisu-tu,時計屋
중세의 현악기	ヴィオラ・ダ・ガンバ,ヴィオラ
해군 소장	しょうしょう
책략이 있는	巧妙な,狡い,ずるい,狡猾,悪賢い
군인다운	軍事的な
동굴 탐험가	穴居人
허벅다리	腿,股,太股
규격대로의	常態,正常
면목없음	羞恥心
재즈팬	ヒッピー
각다귀	ぶよ
모가디슈	モガディシュ
감나무	カーキ色,柿,柿の木
인쇄용 잉크	inku
예외 없이	一般に
셀레베스	スラウェシ島
덧붙여 말하자면	ところで,ちなみに
전립선	zenritsusen,前立腺,ぜんりつせん
프로탁티늄	プロトアクチニウム
프로이센	プロイセン
경험주의의	実証的
압축 펌프	圧縮
쿠웨이트	1. クウェート 2. クウェート
란타늄	ランタン
총상 화서	総状花序
1주간의	毎週の
마드라스	チェンナイ,マドラス
제라늄	ゼラニウム
정복할 수 없는	乗り越えられない
자음표	音節文字
참을수 없음	不寛容
란탄족	ランタノイド,希土類
전리품	戦利品,略奪品
불을 뿜는 용	竜,ドラゴン
허드렛 일꾼	広く浅く,万屋
마음에 두는	眠らずに
유행의	oshare,オシャレ,おしゃれ
고의의 기물파괴	あらし
블루베리	ブルーベリー
가돌리늄	ガドリニウム
세부아노어	セブアノ語
전매품	専売,独占
2중 모음	二重母音
낙천주의	rakuten,らくてん,楽天
공기조절	クーラー,空調装置,エアコン,空調,冷房装置,空気調節,空気調和,家電製品,冷房
포르투갈어	1. ポルトガル語 2. ポルトガル語
은퇴자	退職者
푸줏간 주인	肉屋
법정 불환 지폐	不換紙幣
부패하아	1. 腐る 2. 腐る
작은길	jindō,じんどう,人道
고생물학	古生物学
마음에 드는	魅力的な,みりょくてきな
주 1회의	毎週の
이집트	エジプト
조가비	貝殻
백포도주	白ワイン,白葡萄酒
풀솜 같은	ふかふかした,ほっこり
음절 문자표	音節文字
나고야	名古屋,なごや,名古屋市
저마늄	ゲルマニウム
절망 상태	絶望,ぜつぼう,zetsubō
자장가	子守歌,ララバイ
기회주의	適切な
자전거	自転車
전매권	専売,独占
진주 같은 것	梨,梨の実
자율성	自治,自主性
조각상	ぞう,zō,像
인지질	リン脂質
클레오파트라	クレオパトラ
의붓어머니	継母
오염 물질	おせんぶっしつ,汚染物質
자이레	コンゴ民主共和国,コンゴ民主共和国（旧ザイール）,ザイール,コンゴ共和国,コンゴ民主共和国 (キンシャサ)
나그네	ryojin,tabibito,旅人,りょじん,たびびと,tabinin,たびにん
증기응결기	冷蔵庫
마법사의 돌	賢者の石
의치상	いれば,入歯,ireba,総義歯
란타넘	ランタン
밀리그램	マイクログラム,mg
예측못할사건	成功報酬
작은섬	島,小島
러시아	ロシア連邦,ロシア
양반답게	そっと
검둥오리	オオバン
종합 사회자	アンカーマン
무서워하는	パニック状態
잡종개	雑種
페르미 입자	フェルミ粒子
발레아레스 제도	バレアレス諸島
한정적으로	必ず,確かに,きっと
알레고리	1. アレゴリー,寓言,ぐうげん 2. アレゴリー
장원형	楕円
저하시키다	悪化する,低下する
소강 상태	小康
하바로프스크	ハバロフスク
기형 발생 물질	テラトゲン,催奇形物質
풀을 말리는 사람	テディベア
적법성	合法,合法性
동시주의	共時性
잠잠함	小康
전방에	1. 前へ 2. 前へ
꾸짖다	叱る,しかる
승자 진출전	トーナメント
인정있는	人道的な
상대론적인	相対論的
요코하마	横浜,横浜市
발암성 물질	発癌物質
간단한	簡単な
편하다	ben na,べんな,便な
꾸준히	1. しっかり 2. しっかり
융해점	融点
신성 로마 제국	神聖ローマ帝国
눈물을 흘리다	しくしく泣く,すすり泣く,泣く
유틀란트 반도	ユトランド半島
어지럽히다	気をそらす
폭음하다	ガブガブ飲む
잔잔한	さらさら,さらさらと,つるつる
콩고 민주 공화국	コンゴ民主共和国,コンゴ民主共和国（旧ザイール）,ザイール,コンゴ共和国,コンゴ民主共和国 (キンシャサ)
저명한	有名な,nadakai,なだかい,名高い,高名な,有名
튀어 오르는	ビクビク
코스타리카	コスタリカ
기분이 좋지 못한	くもり,(kumori)
가득히	存分に,十分
죽음의 도시	墓地
머리털이-인	毛深い
1주간 계속되는	毎週の
장엄한	素晴らしい,subarashii,見事,素晴しい,立派な
램제트	ラムジェットエンジン
구자라트 주	グジャラート,グジャラート州
여족장제	家母長制
저녁때 해질녁	黄昏,薄明,日暮
연락하다	仲介する
참을수 있는	まあまあ
편한일	asameshimae,朝飯前
아주 기뻐서	うれしく,運良く,楽しく,ureshiku
잠자리	蜻蛉
조금씩	1. 少しずつ,小刻みに 2. ようやく,小刻みに
자만하여	無益
음탕한	嫌らしい,エッチ
생각에 잠긴	反射的な
이국풍의	esotica,エキゾチック
조금은	一部,部分的に
물결 대시	波ダッシュ
음식물의	栄養素
정맥동	副鼻腔
무리하게	強制的に
정말로	必ず,zehi,正に,是非,その通り,屹度,実に,確かに,確実に,きっと,ぜひ
마다가스카르	1. マダガスカル 2. マダガスカル
프로메튬	プロメチウム
성물을 훔치는	mottainai,もったいない
코코야자	ココナッツ
포괄적인	包括的な
절연체	誘電体
조리실	調理,料理
진저리 나는	退屈な
악화시키다	1. 悪化する 2. 悪化する,低下する
근심걱정에 시달린	やつれた
조리법	調理手順,レシピ
가늘고 긴 돛배	分配,割り当て
..에게 돌리다	任命する
풀베는 사람	草刈り,芝刈り機
아르기닌	アルギニン
지불불능	支払不能
일본군 성노예	慰安婦,従軍慰安婦
반항하는	憎い
표면상	思しい,明らかに,明白に,らしい,明らか
말단거대증	先端巨大症
스리랑카	セイロン,スリランカ
인정하다	公言する
외대박이 돛배	スループ
설명하다	明示する,説明する
믿기 어려운	驚異的な,インクレジブル,ありえない,飛躍しすぎている,信じられない
액솔로틀	ウーパールーパー,アホロートル
수평 낙하하다	パンケーキ
로마자	ラテン文字,ローマ字
후추나무의 일종	ピーマン
히스속의 식물	ギリュウモドキ
앨리게이터속	アリゲーター属
엘살바도르	サルヴァドール,エルサルバドル
자폐증	自閉症
타슈켄트	タシケント,タシュケント
전염병	梅毒
종자 식물	顕花植物
지레 받침	支点
천체물리학	宇宙物理学,天体物理学
암기하다	記憶する
스탈린주의	スターリニズム,独裁政治,幕府,bakufu,独裁
신학교 교장	牧師
통학버스	スクールバス
익히다	慣れる
표백기	漂白剤
산골짜기	峡谷
인회석	燐灰石
성 금요일	受難日,聖金曜日
아나운서	アナウンサー
기계어로 쓰인	絶対,絶対な
레시피	調理手順,レシピ
토너먼트	トーナメント
투옥하다	1. 刑務所に入れる,投獄する,けいむしょに入れる 2. 刑務所に入れる,けいむしょに入れる
마르세이유	マルセイユ
노간주나무	ネズ,杜松,ビャクシン
원자력 발전	かくほゆうこく,kakuhoyūkoku,核保有国,原子力
플래시카드	教材用のカード,フラッシュカード
껍질을 벗기다	上陸する
카스토르	ビーバー
성신 강림 축일	聖霊降臨祭,聖霊降臨,ペンテコステ
기화하다	蒸発する
생명과학	生命科学,ライフサイエンス
잘못된 평가	いさん,isan,違算
의 뜻의 결합사	味噌,みそ
시기에 맞게	適当に
꿈꾸는듯 한	1. 遥か 2. 遥か
저어새	ヘラサギ
상냥함	法令遵守
내국세	情報検索
상냥한	愛想のいい
상륙시키다	上陸する
플랑드르	フランドル,フランダース,フランデレン地域,フランドル・フランセーズ,フランデレン州
야전 병원	野外病院
장악 마개	梱包
그에 따라서	したがって
나르시스	suisen,水仙
가볍게 삐다	挫く
캠브리지	ケンブリッジ
값비싼	1. かちたかい,価値高い,kachitakai,貴重,大切な 2. 貴重
완고한 보수주의자	飛行船
가상법	仮定法,接続法
도피장소	アルザス地域圏,アルザス
고기잡이 그물	魚網
인터페론	インターフェロン
레슬링	1. レスリング 2. レスリング
고기의 달걀말이	春巻き
견갑골	肩胛骨,肩甲骨
웹 페이지	ホームページ,ウェブページ
개인용 컴퓨터	マイクロコンピュータ,パソコン,マイコン
사과하다	詫びる,謝る
공언하다	公言する
조미료	1. 香辛料 2. グルタミン酸ナトリウム
점유자	持ち主
감비아	ガンビア
적절함	手腕
라틴어	ラテン語
선거 위원단	大學,学園,大学,学寮,単科大学
새기다	1. 切る 2. 切る
적절히	適当に
슈트케이스	スーツケース
제약사	薬剤師
가상의	1. 仮想 2. 仮想
가사집	語彙
간섭계	干渉計,かんしょうけい
로렌슘	ローレンシウム
재판소	司法
여러 가지로	色々
자회사	子会社
가속도	そくど,速さ,速度
각색자	アダプタ,アダプター
로사리오	ロザリオ
돌연 변이 유도물	変異原,変異原性
낙농업	酪農場,牛乳屋,牛乳販売店,日用雑貨店,牧場
젊은이	少年,ティーネージャー
낙농장	酪農場,牛乳屋,牛乳販売店,日用雑貨店,牧場
이스라엘의 국회	クネセト
주야 평분점	分点
레소토	レソト
노예 소유	奴隷
가리는 것이 많은	快い
양식이 없는	非実際的
이국적인	esotica,エキゾチック
점유권	占有権,特権
각성제	アンフェタミン
거대한	莫大な,dekai,dekkai,莫大,でかい,広大,でっかい,広大な,大きい,巨大
각속도	角速度
정어리	イワシ
전자석	電磁石
의지할 데 없는	心細い
테크네튬	テクネチウム
불완전하게 하다	ばらばらにする,ばらばら
가솔린	ガソリン
아르고스	アルゴス
가감장치	アダプタ,アダプター
마오쩌둥	毛沢東
멋쟁이류의 나비	アタランタアカタテハ
조림학	林業
인조인간	じんぞうにんげん,人造人間
인공위성	人工衛星,衛星
빈 것	採用
병구완간호	かんご
가소제	可塑剤
조류학	鳥類学
조립자	アセンブラ,asenbura
싫은 소리	ノミ,蚤
꾀하다	想像する,そうぞうする
사과파이	林檎パイ
저장소	kura,倉
간사한	巧妙な,狡い,ずるい,狡猾,悪賢い
지나가는 비	いっそう
난독증	ディスレクシア,失読症
노심 융해	炉心溶融
열의없는	物憂げな,無関心な
전술한	前述の
인도주의	人道主義,jindōshugi,じんどうしゅぎ
되풀이하는	イテレーティブな
뉴 칼레도니아	ニューカレドニア
지옥 같은 곳	煉獄
상관성	相関
갈매기	1. カモメ,鴎 2. 鴎
짐 꾸림	分配,割り当て
점성술	占星学,占星術
날이 날카로운	ビクビク
낱낱이	特別,一入,ひとしお,別段,特殊に,特別に
편집부	机,たく
건습구 습도계	乾湿計
동티모르	東チモール,東ティモール
적송품	つみに,tsumini,積荷
상품화 계획	販売
풋내기	初心者
훈령 요청서	国民投票,レファレンダム
대사등에대한존칭	閣下
음란한 여자	イゼベル
확신시키다	自覚,自覚させる,納得,納得させる,説得,説得する
건강히	健康的に,健康に
분리주의	分離主義,ぶんりしゅぎ
적색왜성	赤色矮星
시아파의 사람	シーア
주임 목사	牧師
살균제	1. 消毒 2. 殺菌剤
유용한 물건	商品
광메이저	レーザー
고위 성직자	教皇,法王,ポープ,ローマ法王,ローマ教皇
본래부터 싫은	嫌って
플라멩코	1. フラメンコ 2. フラメンコ
개라지	整備工場
알레르기	アレルギー,arerugī
레이저	レーザー
전술가	戦術家
베르사이유	1. ヴェルサイユ 2. ヴェルサイユ
알레르겐	アレルゲン
두드러기	蕁麻疹
되풀이하여	しばしば
배신행위	不忠実,不信実,不貞
사냥꾼	狩人,ハンター
일반투표	国民投票,レファレンダム
사나움	激烈
순서가>임	優先権
상극인	どっちつかず
남김없는	懇切な
제상 장치	解氷剤,溶氷剤
음흉한	巧妙な
장축단	アプス,長軸端
감마선	ガンマ放射線
재채기	くしゃみ
헤파이스토스	ヘーパイストス
이트륨	イットリウム
금주하는	禁欲
담력이 있는	いさましい,勇敢な
자치체 당국	自治体,町,都市
구경양배추	コールラビ
조동사	補助動詞,助動詞
로라시아 대륙	ローラシア
항복하다	諦める,降伏する
갈못집	妓楼,売春宿,ぎろう
미친 사람	kyōjin,きょうじん,狂人
양탄자재료	カーペット,絨毯
케임브리지 대학	ケンブリッジ
머큐리신	水銀
물적 재산	不動産
비능률적인	不能な
인공지능	アーティフィシャルインテリジェンス,人工知能
고대 시리아	シリア
3개월간	四半期
일하다	1. 働く 2. 運営する 3. 働く
자판기	自動販売機
포악한	独裁的な
콩고 민주공화국	コンゴ民主共和国,コンゴ民主共和国（旧ザイール）,ザイール,コンゴ共和国,コンゴ民主共和国 (キンシャサ)
몽중보행	睡眠時遊行症
도망하다	くたばれ
미리 알다	予見,予言する
액정 디스플레이	最小公分母,液晶ディスプレイ
가벼운거짓말	罪のない嘘,悪意にない嘘
이따금의	時折の,偶発的,偶然な,偶,時折
평화를 애호하는	平安な,安静な,平和な
정숙한	よい
정신병	精神異常
사기꾼	偽善者,ぎぜんしゃ,gizensha
실험적인	実験的
분류하다	分類する
자동차 소유자	運転手
페르세포네	ペルセポネー
개밥바라기	宵の明星
뿔있는	むらむら
미술적인	芸術的な
해오라기	1. 白鷺,鷺,サギ 2. 鷺
로미오	ロミオ
사과술	シードル,果実酒
의 명소를구경하다	祝う
평지씨	菜の花
중국 귤	北京語,華語,国語,北京官話,普通話
포위 공격	包囲,攻城戦
사라지다	1. 去る 2. 消える
살구빛	アンズ
좆되다	ファックする,セックスする,はめ倒す,セックスをする,寝ると,エッチする,嵌める,性交する
마케도니아	マケドニア
포유병	哺乳びん,哺乳瓶
실물그대로	勿論,もちろん,当然
임파선	リンパ節
실험용의	実験的
컴퓨터 언어학	計算機言語学,計算言語学
꼰 담배	お下げ
삼각형	三角形
포위자	とうしか,出資者,投資家,しゅっししゃ
로스앤젤리스	ロサンゼルス
임파액	リンパ液
물리 요법	理学療法
나락의	極端な
무의식 중의	偶然の
제사장	教皇,法王,ポープ,ローマ法王,ローマ教皇
감미료	1. 甘味料 2. 甘味料
각별히	特別,一入,ひとしお,別段,特殊に,特別に
라호르	ラホール
중심 인물	スパークプラグ
삼각법	三角法
각별한	特別な
가분수	仮分数
론 테니스	テニス
아프리카	あふりか,アフリカ
정서법	正書法,文字,文字綴り,オーソグラフィー,綴り,スペリング
폐진증	肺塵症
아르메니아	アルメニア
사기성	誤謬
보답하다	交換する,返す
임팔라	インパラ
포유류	哺乳類,哺乳動物
색소폰 연주가	サキソフォン
점성학	占星学,占星術
전염성 단핵증	伝染性単核球症
앵무새의 일종	1. コカトゥー 2. 脊黄青鸚哥
추측하다	想像する,推測する,そうぞうする,想像
전자장치	ブラックボックス
깡통따개	かんきり,缶切り
무정부상태의	アナキズム,無政府主義
제 1차 세계대전	第１次世界大戦,第一次世界大戦
영국인의	英国の,イギリスの
12月	師走,じゅうにがつ,十二月,12月
비겁하게도	臆病な
점착성	粘度
아마겟돈	ハルマゲドン,アルマゲドン
커스터드 소스	カスタード
독창적으로	本来
편자공	装蹄師,鍛冶屋
중고의	中古
전율하다	震え
~기로 하다	思い切る
심장병 전문의	心臓学医
중견수	中堅手
향락주의	快楽主義
오르막길	1. 登り,昇天 2. 上り坂 3. 登り 4. 上り坂
카보베르데	カーボベルデ
점차로	ようやく,小刻みに
점착력	忍耐,堅持
오를레앙	オルレアン
조사의	実情調査
GUI	グラフィカルユーザーインターフェース
은하 소우주	天の川,天の川銀河,銀河
아나그램	アナグラム
중국어	北京語,華語,国語,北京官話,普通話
중국인	中国語
사랑의 소곡	マドリガーレ,マドリガル
빙상요트	砕氷船
사랑의 사자	キューピッド
판게아 대륙	パンゲア大陸
모리셔스	モーリシャス
정찰대	警備
대륙이동	大陸移動
토오쿄오	帝都,とうきょう,Azabu,東京
조산원	助産婦
이 이상	nagaraku,ながらく,長らく
데이터의 형식	フォーマット
제책기	ホッチキス
노예의 신분;속박	奴隷
여행가방	1. スーツケース 2. 荷物,手荷物,スーツケース,かばん,鞄
의심을 나타내는	ayashii,怪しい,怪しむような,疑いの,あやしい
중금속	重金属
월경중인	病気
전치사	前置詞
예민하게	痛切に,切実に
프로페인	プロパン
야만 행위	あらし
공기펌프	真空ポンプ
다르에스살람	ダルエスサラーム
외국인을 싫어함	外国人排斥,外国人恐怖症,外国人嫌悪
싱가포르의	1. シンガポールの 2. シンガポールの
겉보기에는	思しい,明らかに,明白に,らしい,明らか
회의사항	計画,議事,日程
전제론자	かせい,専制
말레이 반도	マレーシア,Marēshia
놀라게 하다	1. 驚かせる 2. 驚かす,仰天させる,驚かせる
미분방정식	微分方程式
황색 인종의	黄色い
신하의 영지	しんじゅう
꿋꿋함	勇気
폼알데하이드	ホルムアルデヒド
반복하는	イテレーティブな
전기뱀장어	デンキウナギ,電気ウナギ
화학 요법	化学療法
정치가	煽動
퇴역군인	古兵
動詞	動詞
평온한	平安な,安静な,平和な
돼지 저금통	貯金箱
아름답게	綺麗に
자동 양수기	ポンプ
유라시아	欧亜,亜欧,ユーラシア
12개	jūni,じゅうに,十二,ダース
에티오피아	エチオピア,アビシニア
인적 자원	人力,じんざい,人々,人材
기계적 기억	暗記学習
nemo	長方形,ちょうほうけい
조속한	さっさと
기분 나쁜	不気味な
수질오염	水質汚濁,水質汚染
화학 원소	1. 元素,化学元素 2. 元素,化学元素
자군 절제	子宮摘出術
음향효과	音響,音響学
제초기	ターミネータ,明暗境界線,終端器,ターミネーター
제초제	除草剤
어쩔수 없는 운명	必至の,恒常的,避けがたい,常習,避けることのできない,必至,不可避
평의원	上院議員
프랑스 혁명	フランス革命
포스터	張り紙,ポスター
뇌수막염	髄膜炎
에스페란토	エスペラント語,エスペラント
남녀추니의	1. 両性具有 2. 両性具有
애타주의	利他主義
조숙한	soujuku,早熟,そうじゅく
손목 관절	リスト,手首
색슨 사람	サクソン語,サクソン人
필사적인 용기	尻,ケツ
꽃식물	被子植物
평안한	平安な,安静な,平和な
포클랜드 제도	フォークランド諸島
조심함	無口
손금보기	手相
렌즈콩	レンズマメ
언어학자	言語学者
라틴 아메리카	ラテンアメリカ
주니말	ズニ語
놀랄 만한	突然
아메리카 합중국	亜米利加,アメリカ大陸,アメリカ州,アメリカ合衆国,アメリカ,米国
위막성 후두염	尻,ケツ
고갈시키다	尽くす
히브리주의	ユダヤ教
포스트모더니즘	ポストモダン
계통 발생	進化論
기도서성가	カンティクム
프로펠러식 비행기	トラクター
어떤 사람	人,人間
욕심꾸러기	ハイエナ
名詞	名詞,名前
태양중심의	日心,太陽中心
잘못된 이름	誤称,rangnefni
의심스러운 것	疑い
시계 방향	右回り,時計回り
아나나스	パイナップル
주니족	ズニ語
정치학	政治学
영원한 생명	永生,永世
마이크로 컴퓨터	マイクロコンピュータ,パソコン,マイコン
음향학의	アコースティック
교회의 권위	服従
장식하다	1. 飾る 2. 飾る
단정하게 잘 생긴	ハンサム,ハンサムな
심한눈보라	暴風雪,吹雪
죄는것	狭窄
반측마비	片麻痺
필름 편집	コラージュ
글라스노스트	グラスノスチ
媽媽	疱瘡,天然痘,痘瘡
잔혹한	残酷な,残酷,惨い
발의 위치	見得
밤을 새우는 사람	ふくろう,梟,フクロウ
자기 속도계	タコグラフ
포배엽	胚盤葉
姓	みょうじ,苗字,姓氏,あだ名,名字,姓
조방의	広汎
플로리다	フロリダ,フロリダ州
정전기	静電学,静電気
마음대로 움직이다	強要する
청정 장치	デバッガ
플랑크톤	プランクトン,浮遊生物
열정적인	はげしい,激しい
정장석	正長石
수력;낙수	水力,すいりょく
공리주의의	便利な
비대칭의	非対称
카스피해	カスピ海
에틸알코올	エタノール
졸업 증서	卒業証書,ディプロマ
여행 가방	1. スーツケース 2. 荷物,手荷物,スーツケース,かばん,鞄
덴마크최대의 섬	シェラン島
정장의	燕尾服
과학기술	科学技術,生産技術,工学,テクノロジー,工業技術,技術
장난 좋아하는 요정	パック
히브리어풍	ユダヤ教
라스베이거스	ラスベガス
gan	.婚外性交,姦通,不倫,姦淫,私通,密通
家庭	家庭,世帯,家族
잘 생각해 낸	hashikoi,はしこい
레퀴엠	死者のためのミサ,鎮魂歌
오호츠크 해	オホーツク海
성 잘내는 사람	はち,蜂
근로 장학생	サーバ
포물선	放物線
베트남의 수도	ハノイ
小便	1. ピー,尿,おしっこ,小便 2. 尿,小便
자연선택	自然淘汰,適者生存
저쪽에	あそこへ,そこへ
11월	十一月,１１月,じゅういちがつ,霜月,11月
오해하다	勘違い,誤解
14일	二週間
安寧	健康,げんき,元気
펌웨어	ファームウェア
주임 신부	牧師
10억	十億
10월	十月,神無月,じゅうがつ,10月
오카리나	つちぶえ,土笛,オカリナ
家具	kagu,かぐ,家具
믿을수 없을 만큼	凄く
충심으로	近く
제작자	建築家
팜플렛	小冊子
류머티즘성 관절염	関節リウマチ
자연신교	理神論
實數	実数
하바롭스크	ハバロフスク
결혼하다	結婚する
히브리인의	ユダヤ,ユダヤ人
꾸준히하다	働く
외교 정책	外交
과산화수소	過酸化物,過酸化水素水,過酸化水素
정중면	メソン,メゾン
10만	ラッカー
코르크 재킷	救命胴衣,ライフジャケット
잠깐 쉼	小康
여과성 병원체	コンピュータウイルス,ウイルス
國語	朝鮮人,韓国人
좀벌레	蛾,が
기독교 교파	キリスト教
밀리미터	ミリメートル
안뜰 둘레의 건물	中庭,なかにわ
제조소	こうじょう
스와질란드	スワジランド
라이프치히	ライプツィヒ
Linux	Linux,リナックス
발음 구별 부호	ダイアクリティカルマーク
장황한	冗長な
불가항력의	必然の,避けがたい
대상포진	帯状疱疹
조카의 아들	大甥
주임 사제	学寮長
~제기랄	硫黄
루마니아	ルーマニア
시베리아	シベリア
방사성 원소	プロトアクチニウム
예방하다	予防,防ぐ
홈 페이지	ウェブサイト
스와질랜드	スワジランド
관광 사업	観光
한국 전쟁	朝鮮戦争
플래티나	プラチナ,ぷらちな,白金
팸플릿	小冊子
끄는 도구	トラクター
사죄하다	詫びる,謝る
팸플렛	小冊子
진성 당뇨병	糖尿病,とうにょうびょう
중간권	中間圏
일정적인	回帰線,熱帯
저체온	低体温症
큰 수캥거루	ベビーブーマー
주마등같이 변하는	超現実的
목동자리	羊飼い
수소폭탄	すいばく,水素爆弾,水爆
페이지	ページ
운명 예정설	定め
큰곰자리	1. 北斗七星 2. おおぐま座
구워지다	炙る
평소에	いつもは,俗,通常,tada,何時も,一般に,日頃,大抵,普通に,ただ,いつも
정지한	静止した,変わらない,固定された,止まっている
증오하는	憎い
일반인의	市民の
같은 계통의 것	いとこ,従兄弟,従姉妹
경작;경지;농작물	耕作
주기표	周期表
중간자	メソン,メゾン
일처 다부	一妻多夫制
이리 들린 사람	狼男
비밀 누설	暴露
손해를 주는	害する,損なう
꾸리다	包装する,包む
호화스러운	豪華な,華やか
엘리베이터	エレベーター,昇降機
중간층	中間圏
깊은 바다의	極端な
짓	手工芸
집	1. tatemono,建物,ビル,家 2. 家庭,世帯,家族 3. 家 4. 住居,seki,家屋,せき,住宅,居留
지	ゼッド,ゼドゥ
질	ぼぼ,膣,つび,へへ,そそ
문화기술연구	民族誌
좀	ちょっと
파편의	切れ切れの
테러리스트	テロリスト
점	ネクロマンシー
젖	ミルク,牛乳,乳
적	1. 敵 2. aite,相手 3. 敵
절	段落
재	ガート
즉	つまり,すなわち
즙	ジュース,ジュ—ス
실험실.	実験室,研究室
죄	1. 告発,容疑,告訴,ようぎ,言いがかり 2. 犯罪 3. tsumi,罪,有罪,つみ 4. 有罪,罪悪感
폴로늄	ポロニウム
층	束,層
칼	1. ファルシオン 2. ナイフ,短剣,小刀
전기영동법	電気泳動
춤	1. 踊り 2. 踊り
두족류동물	頭足類
제퍼슨	ジェファーソン
콩	1. 大豆,だいず,ダイズ,daizu 2. 豆 3. 大豆,だいず,ダイズ,daizu 4. 大豆,soia,だいず,ダイズ,daizu
카자흐스탄	カザフスタン
차	1. 茶 2. 茶 3. 茶 4. 茶 5. 茶
창	1. 窓 2. 槍
처	情婦
포르노	ポルノグラフィー,猥褻,ポルノ,エーブイ,猥本,アダルトビデオ
촌	町,村
톤	トン
통	1. 浴槽 2. バケツ
틈	1. けいき,契機,keiki,チャンス 2. 罅
퍽	パック
二月	二月,如月,にがつ,2月
스테인레스	ステンレス・スティール,ステンレススチール
탑	仏舎利塔,ストゥーパ,卒塔婆
탄	石炭,黒炭
모르타르	モルタル
화	1. 怒気,忿怒,いかり,ikari 2. 怒り
환	かわせ,為替
황	1. 硫黄 2. 硫黄色,硫黄
고속도로	1. 高速道路,公道,街道,公路,道 2. 高速道路 3. 高速道路
훈	授業
해바라기속 식물	ひまわり,ヒマワリ,向日葵
흰	白い
폭	幅,巾
폰	ホン
푹	marude,丸で
빈틈없는	計算高い,keisandakai,けいさんだかい,計算可能な
피	血液,血
九月	くがつ,九月,9月,長月
우리 은하	1. 星雲,銀河 2. 天の川,天の川銀河,銀河
햄	ハム
도매상인	商人,shōnin,しょうにん
수치를 아는	正直な
예테보리	ヨーテボリ
종양학	腫瘍学
조제학	薬学,薬局
있는그대로의	正直に
폴란드	ポーランド,ポーランド共和国
플라이어	プライヤー
이디시어	イディッシュ語
七月	shichigatsu,七月,文月,7月,しちがつ
저혈압	低血圧
폭력배	ちんぴら
꾸미다	1. 飾る 2. 飾る
아첨하다	1. お世辞を言う,諂う 2. お世辞を言う,諂う
청량 음료	清涼飲料水,清涼飲料,ソフトドリンク
종업원	従業員,雇員,使用人,勤務員
간결한	簡潔
세포기관	細胞小器官
양자화하다	量子化
남북 전쟁 or 남북전쟁	なんぼくせんそう,南北戦争
생년월일	1. 生日,生年月日,誕生日,誕辰 2. 誕生日
시치미떼는 사람	偽善者,ぎぜんしゃ,gizensha
스파이웨어	スパイウェア
삼위일체	三位一体
겁	恐怖
개	1. 犬科動物 2. 犬 3. 犬 4. 犬
강	かわ,川
감	カーキ色,柿,柿の木
간	売春婦
가	国境
굴	1. カキ 2. カキ
굿	破魔,悪魔払い
굄	沈滞,不振
고정적인	必至の,恒常的,避けがたい,常習,避けることのできない,必至,不可避
골	たに,谷,tani
공	1. ボール 2. ボール 3. 球 4. ボール 5. ボール
주마등	mangekyō
곰	クマ,熊
괌	グアム
겨	もつ,臓物
격	生格,属格,所有格
깨	胡麻,ゴマ
짐바브웨	ローデシア,ジンバブエ
김	蒸気,湯気,気体
긴	長い,ながい,nagai
길	みち,道
금	1. 金 2. きんぞく,金,金属製,金属 3. 罅 4. 金
극	急場しのぎ,どんでん返し
귤	みかん
꽤	比較的,比較的に
꽃	花序
꿀	蜂蜜
꿩	1. 雉,キジ 2. キジ
공식적 개방 정책	グラスノスチ
끝	尻,ケツ
구자라트	グジャラート,グジャラート州
낯	名誉
낮	1. 正午,jūni-ji,昼,真昼,しょうご,shōgo,十二時,じゅうにじ 2. 日
내	1. おがわ 2. かわ,川
난	ナン
낫	1. 鎌,かま 2. 大鎌,鎌
페세타	ペセタ
녹	緑青
천분의 1미크론	ナノメートル
눈	1. 目 2. 雪,天花,yuki,ゆき,玉塵 3. 目 4. 雪,ゆき 5. コカイン
뇨	尿,小便
늘	1. いつも 2. 絶え間なく,いつも
니	門歯
조로아스터교	ゾロアスター教
능	廟,霊廟
닭	家禽
햇볕에 태우다	日に焼ける
돛	きじ,切れ,布
돔	1. 円蓋,天蓋,円屋根 2. 円蓋,天蓋,円屋根
둘	二和音
둔	砂丘
단념하다	失敗する
점화기	ライター
점화구	防火扉
딸	乙女,むすめ,お嬢さん,娘
또	-も,また,も,さらに,にも
떼	星団
여행안내소	旅行の代理店,旅行会社
접합자	受精卵
특히 생산관계의	実業家
똥	1. 大便,くそ,うんこ,ふん,糞便 2. べん,大便,baba,ばば,うんこ,ben,糞
갈겨씀	rakugaki
랙	ラッカー
라	ラ,イ
...에 충분하다	足りる,足る
평시용의	平安な,安静な,平和な
열장이음	蟻継ぎ
롬	ジプシー,ロマ
럼	ラム酒
레	レ,ニ
무	1. 大根,ダイコン 2. ルタバガ,カブハボタン 3. ルタバガ,カブハボタン 4. 〇
문	1. ドア,戸,門,扉 2. ドア,戸,門,扉
조심성 있는	慎重
전횡의	任意,不特定多数
몸	肉,解剖学,人体
세목 놓기 게임	三目並べ
갑갑증	もの憂さ,無聊,アンニュイ,つれづれ
뫼	はか,墓
묘	聖骨箱
명	スローガン,標語
말	1. 成句,諺,ことわざ 2. 言語 3. 馬
센티미터	センチメートル,センチ
맥	バク
매	隼,ハヤブサ
불	1. 火 2. 火 3. 火 4. 炎,kaen,火,火炎 5. 火 6. 火災,大火,火,大火災 7. 囲炉裏,暖炉,だんろ,danro
봉	いとこ,従兄弟,従姉妹
복	1. 鰒,河豚,フグ 2. 鰒,ふぐ,フグ科,河豚,フグ
본	ボン
별	1. 恒星,天体 2. 恒星
병	疾病,yamai,病気,疾患
벌	はち,蜂
벗	親友,友,shin'yū,しんゆう
접합부	連辞,指定詞,連結詞,コピュラ,繋合詞,繋辞
배	1. 舟,船舶 2. 船舶,船
밧	バーツ
밥	稲,舎利,飯,米,イネ
및	さらに
밈	ミーム
뺨	頬骨
빵	1. ライ麦パン,パン 2. パン,pan
비	1. 箒 2. 雨,雨水,あまみず,amamizu 3. 雨,降水,降水量
빈	ウィーン
종자매	いとこ,従兄弟,従姉妹
삼	マリワナ
새	1. 鳥類 2. 家禽 3. 鳥,とり
산	1. 山岳,山 2. 丘,山岳,山
샴	シャム
세	冬,fuyu
성	仮名,あだ名,源氏名,かな,假名
섬	1. 島,小島 2. 島 3. 島
설	情婦
선	腺状
솔	1. 松 2. 松
소	家畜,うし,牛
손	1. 手 2. genko,げんこ,拳固,拳
포트모르즈비	ポートモレスビー
좌우간	なぜか
싸	やすい,yasui,安い,hikui,安価
시	1. 時 2. 時 3. 時
쌀	1. 稲,舎利,飯,米,イネ 2. 稲,イネ
음의 강도의 단위	ホン
쇠	きんぞく,金,金属製,金属
숍	レンジ,オーブン,ストーブ
숨	エネルギー
술	アルコール,酒
숯	石炭,黒炭
숲	森,林,森林
쉬	尿,小便
신성한 물건	秘跡
양	1. 羊 2. 羊 3. 羊,牝羊, 雌羊
가극장	オペラ,オペラハウス,歌劇場
약	1. 医学 2. 薬物,薬 3. 薬物,薬 4. 薬
알	1. 卵 2. 卵 3. 卵子 4. 卵 5. 卵
암	癌,悪性腫瘍,悪性新生物
안	いいえ
씹	1. 性交 2. いんもん,inmon,陰門
씨	1. 実,種子,種 2. 種子,種
위	砂のう,破砕胃,砂肝,砂袋
우	呉方言,ウー,呉語,吳
월	ムーン
인	リン,燐
잘	心地よく
일	宿題,任務
은	1. 銀,gin 2. 銀器,銀 3. 銀 4. 銀
엠	1. エム 2. エム
집산주의	1. 集産主義 2. 集産主義
여	家内,fujin,妻,女子,つま,okusan,奥さん
역	駅,駅(えき, eki),鉄道駅
예	例えば,例,たとえば,tatoeba
영	1. 〇 2. 〇
업	カルマ
엔	エヌ
엘	エル
다이아제팜	ジアゼパム
오	オウ
옷	1. 衣装,衣類,ifuku,いふく 2. 衣装 3. 衣服,服,衣類,fuku
심리학자	精神科医,精神医学者
이슬라마바드	イスラマバード
멀티미디어	マルチメディア,複合媒体
교회를 침범하는	mottainai,もったいない
운영 체제	OS,基本ソフト,オペレーティングシステム
제우스의 방패	催し
심술쟁이	雀蜂,スズメバチ,モンスズメバチ
다 암꽃술	一夫多妻
정형술	整形外科
강기슭	川沿い,川岸,川端
터무니없는	とんでもない
포크리프트	フォークリフト
수평위치	横の,横,水平な,水平
점화전	スパークプラグ
좌익수	レフト,左翼手
종조부	大叔父
초우란의	超ウラン
에스테르	エステル
사상균 병	真菌症
좋은점	推薦
호구지책	生活
가스터빈	ガスタービン
펀자브	パンジャーブ,パンジャーブ州
측미 캘리퍼스	マイクロメートル
포멜로	ブンタン
불가리아어	1. ブルガリア語,ブルガリア人 2. ブルガリア語,ブルガリア人
읽을 수 있는	読みやすい
마리화나 상용자	うすのろ,でくのぼう
폭리의	とんでもない
팜파스	パンパ
레몬 밤	レモンバーム,西洋山薄荷
절대로...아니다	必ず,確かに,きっと
생 마르탱	セント・マーチン
두나라말을하는	バイリンガル,バイリンガルな,二ヶ国語併用の,二カ国語,二か国語の,二ヶ国語の
종지부	。,句点
니더작센 주	ニーダーザクセン州
火	kayōbi,かようび,kayoubi,火曜日
상호 부조론	共生
기껏해야	nagaraku,ながらく,長らく
질식 장치	消火器
포름산	蟻酸
농장 노동자	農家
예방주사	予防接種
신선한 공기	おぞん,ozon,オゾン
중력자	重力子
정확한	精密,正確な,厳密な
아크릴아미드	アクリルアミド
오래가지 않는	短命な,はかない,束の間の
마하라슈트라 주	マハラシュトラ州,マハラシュトラ
성 토요일	聖土曜日
유사 이전	先史時代
신비한 기호	ルーン文字
내색하지 않다	隠す
연장하다	引き伸ばす
반드러운 부분	さらさら,さらさらと,つるつる
과들루프	グアドループ,グアドループ島
원생 동물	プロトプラスト
페스트	ペスト
같게함	方程式
금지하다	禁ずる,禁止する,禁じる
가스파초	ガスパチョ
종신관	えいせい,常,永世
환기 항진	過換気症候群
푸른머리되새	ズアオアトリ
자애적-인	自分本位の,利己的な,わがままな,身勝手な,勝手な
꿰매기	裁縫
추산 위치표	天体暦
꿰매다	1. 縫う 2. 縫う
조약돌	小石,石,sekkai,せっかい
영국의 시인	教皇,法王,ポープ,ローマ法王,ローマ教皇
속죄의 염소	スケープゴート
종속절	従属節
임명하다	1. 任命する 2. 任命する
도미니카 공화국	ドミニカ共和国
포도원	ぶどう園,ブドウ園
100만 헤르츠	メガヘルツ
나노기술	ナノテクノロジー
발견하다	検出する,見付ける
편리함	ユーザビリティ
방향감각의 상실	とまどい
과들루쁘	グアドループ,グアドループ島
드문드문한	散発的
젊은이의	若々しい
퍼센트	パーセント,百分率
닦아내다	拭く
파키스탄	パキスタン
관광 여행	観光
중복 부호	同上
편마비	片麻痺
구리 세공인	銅細工人
위 지방산의 양털	ザクセン
포도당	グルコース,ブドウ糖
대사 산물	代謝物
조악한	粗い
조언자	顧問
副詞	副詞
吝嗇	けち,吝嗇
식탁용 큰 스푼	大さじ
식용 곱창	もつ
무스카트	マスカット
항공 회사	航空会社
포도밭	ぶどう園,ブドウ園
편마암	片麻岩
효성스러운	敬虔,宗教にかこつけた,信心深い,敬虔な
전략상 중요한	戦略的な
라틴어의	ラテン語
이주하다	移民する,移行する
아돌프 히틀러	アドルフ・ヒトラー
생물물리학	生物物理学
장편소설	イリアス
왼손의 타격	サウスポー
午後	gogo,午後,夜,ごご
종신수	囚人
뉴기니 섬	ニューギニア島,ニューギニア
가두녀성	主婦
거침없이	1. さらさら,さらさらと,つるつる 2. ペラペラ,ぺらぺら,さらさら,流暢に,すらすらと,さらさらと,ぺらぺらと
동시편재	ユビキタス
루비듐	ルビジウム
뜰 가꾸기	庭いじり
극히 미세한	マイクロスコープ,顕微鏡
무정부주의	アナキズム,無政府主義
양성 소질	両性愛
검독수리	イヌワシ,狗鷲,犬鷲
극도의 절약	倹約
조울증	双極性障害
슬로베니아 공화국	スロヴェニア,スロベニア
뒤를 보다	大便をする,くそをする
조용함	安穏,安寧,あんねい
물리 화학	物理化学
자카르타	ジャカルタ
귤빛의 물감	北京語,華語,国語,北京官話,普通話
저항기	抵抗器
개량하다	上達する,上達させる,改善,良くなる,改善する
전해 들은	中古
중성미자	中性微子,ニュートリノ
세바스토폴	セヴァストポリ
뿌리다	1. 種をまく 2. 種をまく
입밖에 내지 않은	黙々
지빠귀의 무리	クロウタドリ
人類	人類,人間
亜鉛	亜鉛
프로키온	プロキオン
mama	疱瘡,天然痘,痘瘡
트리니다드 토바고	トリニダード・トバゴ
죄받을	mottainai,もったいない
~할 가치가 있다	値する
불투명한	不透明な
현재분사	現在分詞
구름 무늬의	くもり,(kumori)
오클라호마 주	1. オクラホマ州,オクラホマ 2. オクラホマ州
빈틈없는사람	ウナギ,鰻
기운을 북돋우는	こころづよい,心強い
단봉낙타	ヒトコブラクダ
파인애플	1. パイナップル 2. パイナップル
광저우 시	1. 広州市 2. 広州,広州市
보스입자	ボソン,ボース粒子
선회하는 것	人工衛星,衛星
실업 학교	実業学校
지구 물리학	地球物理学
존재론	オントロジー,存在論
물에 뼈져 죽다	水死する
적혈구	赤血球
생명보험	生命保険
제트기	: ジェット機,じぇっとき
적절하게	ところで,ちなみに
제  1인자	おうじ,ōji,王子
식료품 계원	バトラー
하느님께 바치다	恵む
冊房	本屋,書店,ほんや,hon'ya
아말감화	統合,合併
일락에 빠지는	官能的な,肉感的な,豊満な
신성하게 하다	恵む
보편적으로	一般に
전 회교도	回教
앞으로 영원히	永遠
저항력	インピーダンス,電気抵抗,抵抗
감사하다	1. 褒める,歓迎する 2. 感謝する 3. 感謝する
타밀나두	タミル・ナードゥ州,タミル・ナードゥ
더 비틀즈	ザ・ビートルズ,ビートルズ
지금부터 전에	以前に,以前
스포츠담당기자	スポーツマン,スポーツ愛好者
？	疑問符,？
69체위	シックスナイン
급격하게	1. 突如,急に,突然,突然に 2. 突然 3. 突然,突然に
조장석	曹長石
가계도	家系図
가장 중요한 인물	パパ,父親,お父さん,父上,父,親父
다이얼로그	交渉人
바이러스학	ウイルス学
재산을 상속하다	継承する,受継ぐ
보통은	いつもは,俗,通常,tada,何時も,一般に,日頃,大抵,普通に,ただ,いつも
보통의	いつもの,tada,ただ
젖꼭지	乳頭,乳首,ニップル
인식력	心得,chishiki,学識,ちしき,認知,こころえ
해독성 독소	解毒剤
커피숍	kafe,コーヒーハウス,珈琲,コーヒー店,喫茶店,カフェ
입상자	じてん,jiten
재배지	プランテーション
커피점	kafe,コーヒーハウス,珈琲,コーヒー店,喫茶店,カフェ
명예로운	正直な
일신교	一神教
단련하다	慣れる
풀깎는 기계	草刈り,芝刈り機
헝가리	ハンガリー
육체의	官能的
이디오피아	エチオピア,アビシニア
콘월어	コーンウォル語,コーンウォール語
펠라그라	ペラグラ
인슐린	インシュリン,インスリン
음이온	陰イオン,アニオン
겁을 내어	臆病な
辭典	辞書,じびき,字引,jibiki,字書,語彙,字典
보편적인	カトリック,カソリック
음침하고 큰 건물	廟,霊廟
서스캐처원	サスカチュワン州
카톨릭교회	ローマ
한반도	朝鮮
보통화	北京語,華語,国語,北京官話,普通話
곡물창고	エレベーター,昇降機
일신론	一神教
잠비아	ザンビア
저능아	うすのろ,でくのぼう
비열한놈	くそったれ
에콰도르	エクアドル
해로운	1. 害する,損なう 2. 害する,損なう
음전자	電子,でんし
의외의	igai na,いがいな,意外な
저당권	抵当,住宅ローン,抵当権
강제적으로	1. 強制的に 2. 強制的に
노르웨이의 수도	オスロ
옥수수 기름	コーン油
음절의	有声
입선자	じてん,jiten
파산선고	裁決
하버드	ハーバード
상상 임신	想像妊娠
수재 교육제	能力主義
응용된	応用
유대의예언자	エズラ記
진절머리나는	くだらない
기금같은	ごますりの
수상돌기	樹状突起
할머니	祖母,お婆さん,そぼ,外祖母,おばあさん
예절없는	無礼な,失礼,無礼
사과주스	シードル,果実酒
합작하다	(敵に) 協力する,共同して働く,協力する
전나무	モミ,樅の木
인색한	勘定高い,かんじょうだかい,kanjōdakai
일상의	いつもの,tada,ただ
부싯돌	1. 燧石 2. 燧石
이슬비	小雨,霧雨
생략기호	アポストロフ,アポストロフィー,省略符号
이신론	理神論
의용군	民兵
T 셔츠	ティーシャツ,Tシャツ,Ｔシャツ
판단의 표준	判断の尺度
휴식 시간	珈琲
폐색전선	閉塞前線
형편좋은	適切な
함정장치	障害物,ブービートラップ
습격하다	攻撃する
염소자리	山羊座,磨羯宮,やぎ座
인성학	動物行動学
불성실	不誠実
후춧가루	黒こしょう,白コショウ,白こしょう,白胡椒
은제품	銀器,銀
인쇄인	印刷業者
제네바	レマン湖,ジュネーヴ,ジュネーブ
전도성	熱伝導,伝導度
오리 너구리	カモノハシ
원핵생물	原核生物
절대의	絶対,絶対な
곤란하게 하다	懲罰する,ばっする,制裁する
피부과	皮膚科学
절도광	窃盗症
이안류	離岸流,りがんりゅう,riganryū
전당포	質屋
두들기는기구	ビーター
전동력	電圧
봉토둑	小山,丘
할로윈	ハロウィン,ハロウィーン
재빨리	1. 早々,早速 2. 早々,早速
뉴스 보도자	ジャーナリスト,記者,リポーター,報告者
핸드폰	携帯,けいたいでんわ,携帯電話,セルフォン,ケータイ,セルホーン
재빠른	さっさと
무사마귀	イボ
유치한	幼稚
포유동물	哺乳類,哺乳動物
핸디캡	障害物,欠点
예배 규칙서	ディレクトリ
피부염	皮膚炎
제노바	ジェノヴァ
고미다락방	1. 屋根裏部屋 2. 屋根裏部屋
제조업자	製作者,生産者
이어서	それ,それから,その後,後で
자수정	アメシスト,アメジスト,紫石英,紫水晶,紫色
입신한	幸運な,成功した,成功裏の
마리네드에 담그다	マリネにする
돼지꼬리	お下げ
어휘학자	語彙論
하이데라바드	ハイデラバード
인종적 증오	人種差別
하르툼	ハルツーム
이어링	イヤリング
하마스	ハマース
크르와상	クロワッサン
한마디	音節
의좋은	なごやか
자세히	特別,一入,ひとしお,別段,特殊に,特別に
마라케시	マラケシュ
대제사장	高僧
전능의	全能
할로겐	ハロゲン
동화작용	同化
남자친구	kare,カレ,カレシ,kareshi,かれし,ボーイフレンド
불신앙	不信心
값싼 붉은 포도주	赤字
똥구멍	肛門
불시의	igai na,いがいな,意外な
불신자	異邦人,不信者
일시의	短命な,はかない,束の間の
부룬디 프랑	フラン
음절표	音節文字
언외의 의미	含意
반죽하다	捏ねる,練る,こねる
보풀의	ふかふかした,ほっこり
귀부인 같은	女らしい,おんならしい
자서전	自伝
미니스커트	ミニスカート
디코딩	復号化,暗号解読
의인화	擬人観,擬人化
적당히	適当に
비구니	尼,尼僧
불쌍한	かわいそうな,かわいい
의의학	意味論
돼지기름	ラード
절대로	何時でも,万々,曾て
풍토성	固有種
자석영	アメシスト,アメジスト,紫石英,紫水晶,紫色
커플링	結合
여러 차례	しばしば
비겁자	ディンゴ
당좌 계정	当座預金
전란의 터	操縦席
유치원	幼稚園
페라이트	フェライト
재보험	再保険
인용문	引用文,引用
상표 등록 방해자	aite,相手
속태우다	騒がす,いらいらさせる,苦しめる,煩わす
유태인	1. ユダヤ人,ヘブライ語 2. ユダヤ人 3. ユダヤ,ユダヤ人
로도스섬	ロードス島
정당한	合法性
영광스러운	栄光
제대로	心地よく
중심인물	スパークプラグ
영광스럽은	栄光
말라리아의 독기	マラリア
떠벌린	無理な,誇張された
피스톤	ピストン
핵반응	核反応
거세된 남자	宦官
단편 소설	短編小説
필수의	1. 必要な 2. 必要な
스코틀랜드	スコットランド,蘇格蘭
상식 있는	バランスの取れた,常識のある
해밀턴	1. ハミルトン 2. ハミルトン
metiko?	metiku
믿을수 없는 녀석	がらがら蛇,ガラガラヘビ
접두사	接頭辞
예금 통장	通帳
하사금	心付け
일원론	一元論
하사관	1. 軍曹 2. じゅんい
해변복	水泳着,水着,海水着
기분 좋은	愉快な,たのしい,愉快,tanoshii
불구 발육부전	人工流産,妊娠中絶,中絶,人工妊娠中絶
푸에블라	プエブラ
음경에의 구강성교	フェラ,尺八,フェラチオ,しゃくはち
너무 삶다	過ぎる
미리 앎	予知
필수품	必要,nyūyō,入用,にゅうよう
일요일	日曜日
입양아	養子
해변에	上陸,陸上,陸上に
장소의	空間的
해변의	りんかい
놀기 좋아하는	茶目な
거짓눈물	嘘泣き
신문잡지판매소	通信社
몽고 인종의	黄色い
절도죄	盗み
연료전지	燃料電池
그 재목	ポプラ
우곡 십자 기장	卐,卍,ハーケンクロイツ
자유주의	1. 自由主義 2. 自由主義
데이터 처리 장치	コンピューター,計算機,電子計算機,電算機,電卓,コンピュータ
유쾌한	陽気な
앙그라 마이뉴	アンラ・マンユ
아이스크림	アイスクリーム,aisukurīmu,アイス
퍼붓는 비	大雨,土砂降り
실존주의자	実存主義者
일어남	反乱,ほうき,hōki,暴動
육해공군 공동의	水陸両用
고의가 아닌	偶然の
학생 유게실	居間,リビング
모르고 있음	無知,めくら,盲,不知
한랭 전선	寒冷前線
쿠미스	馬乳酒,クミス
이어폰	ヘッドホン,イヤフォン
우르두어	ウルドゥー語,うるどぅーご,urudūgo
관대히 다루다	黙認
불꽃놀이	花火
의지할 사람	信頼
불평하는 사람	原告
野菜	野菜,緑黄色野菜
가장 중요한 것은	重要
늪이 많은	浸水した
불명확하게	itsumademo,何時までも,いつまでも
물뿌리개	じょうろ
인용구	抜粋
연대 책임	結束,連帯
이윽고	その内,実際に,今
난쟁이 꼬마	エルフ
의지의	意識的な
빈정대는말	当てこすり
정당의	政治上の,政治的な
잠무 카슈미르 주	カシミール,ジャンムー・カシミール州
서부독일의수도	ボン
부수사고	成功報酬
침팬지속	黒猩々,チンパンジー
하모니카	口琴,ハーモニカ,口風琴,ハープ
이원성	二重性
응축물	凝縮
그 주도	ジェノヴァ
청진하다	聴診,聴診する
배드민턴	バドミントン
이중성	連星,二重星
인조의	人工的な,人工の,人為的な
음역하다	字訳
진공 청소기	掃除機
똑같은	似ている,同じような
똑같이	1. 同じく 2. -も,また,も,さらに,にも
북빙양	北氷洋,北極海,北極洋
네발 짐승	四足歩行,四足獣,四本脚
장식의	飾る
철근콘크리트	鉄筋コンクリート
체코 공화국	チェコ,チェコ共和国
실룩거리는	ビクビク
비엔티안	ヴィエンチャン,ビエンチャン
수염을 깍다	理髪師,床屋,美容師
분비의	口堅い,口が堅い
변호사	1. 弁護士 2. 代言人,弁護士
핼리벗	オヒョウ
전략의	戦略的な
자연수	非負数,自然數,正数,自然数
컴퓨터	コンピューター,計算機,電子計算機,電算機,電卓,コンピュータ
동닿지 않은	不調和な
유포늄	ユーフォニアム
dorig?	dōriku
직업 직함	仕事
몬테레이	モンテレー
부자연하게	人工的に
켈트족	ケルト人
상대도수	周波数
자살 행위	ロシアンルーレット
전기독교도	キリスト教
마이크로코드	ファームウェア
작용기	官能基
틀림없이	必ず,zehi,正に,是非,その通り,屹度,実に,確かに,確実に,きっと,ぜひ
자연어	言語,自然言語
응축액	凝縮
임의의	ランダムな,任意の,勝手気まま,勝手気ままな,不可解,無作為な,出任せ,出任せの
발명의재주	巧妙
마가복음	マルコ
마라티어	マラーティー語
조각가	彫刻家
구명 자켓	救命胴衣,ライフジャケット
잠수함	1. 潜水艦 2. 潜水艦
쓸모없이 된	時代遅れ,廃れた,退化した
말티니크	マルティニーク,マルティニーク島
셀시우스	セ氏,摂氏,セルシウス
아젤바이자니어	アゼルバイジャン語
가라앉히다	なだめる
일장기	目玉焼き
한밤중	1. 真夜中,yonaka,よなか,しんや,深夜 2. 正午,jūni-ji,昼,真昼,しょうご,shōgo,十二時,じゅうにじ
소수독점	寡占
디지탈	デジタル
이전에	1. 旧来,かつて 2. 予め,あらかじめ
공포 정치가	テロリスト
쿠마시	クマシ
전쟁 포로	捕虜
인종적 차별	人種差別
일용품	商品
에딘버러	エディンバラ
해마다	年一回,毎年,年一回の
약 빠르지 못한	不器用な,ぎごちない
조사에 종사하는	実情調査
인젝션	ちゅうにゅう,chūnyū
연체 동물	軟体動物
카라카스	カラカス
정렬 알고리즘	ソート
인터링구아	インターリングア語,インターリングア
시기를 놓친	ainiku no
중대 국면	境目,不景気
1파인트들이 그릇	パイント
부산물	副産物
우리나라	朝鮮
단풍나무	かえで,カエデ
교조주의	1. 教義 2. 教義
위험한	1. 危険な 2. あやうい,危うい,ayaui,あぶない,abunai
주사위 놀이	バックギャモン
젖떼다	やめさせる,乳離れさせる
인자형	遺伝子型
장수학	老人学,老人医学
한벌의	十二進法
디스토피아	ディストピア
유아의	幼稚
볼가 강	ボルガ川
필경에는	やっと,ついに,結局,最終的に,とうとう
산사나무속	サンザシ
대접받침	そろばん,頂板,算盤
트리케라톱스	トリケラトプス
끌어 들임	熱伝導,伝導度
낭비가 많은	不能な
스케이트	スケーティング,スケート
저항을 그만두다	諦める,降伏する
분음 기호	分音符号
보증인	スポンサー
헛되이	1. 不用に 2. 無益
피의자	被告
불량자	ちんぴら
수염 없는	さらさら,さらさらと,つるつる
코뿔소	犀,サイ
해사의	航海
창고 관리인	商人,shōnin
유아어	愛称
캠프장	キャンプ場,野営地,テント場
소매상인	1. 商人,shōnin 2. 商人,shōnin,しょうにん
개선하다	1. 上達する,上達させる,改善,良くなる,改善する 2. 直す,癒える,癒す,治る 3. よくなる,改善する
카테테르	カテーテル
기호변환 프로그램	アセンブラ,asenbura
형광성	蛍光,けいこう
수다스러운	おしゃべり好きな
필요물	必要,nyūyō,入用,にゅうよう
항성의	1. 恒星の（こうせいの,星の 2. 恒星の（こうせいの,星の
익명자	筆名,雅号,ペンネーム
해산물	シーフード,魚介類,海産食品,海産物,海鮮
용한사람	ブルドッグ
섬광적인	どぎつい,あくどい,けばけばしい,派手な
인명부	ディレクトリ
자력계	磁気センサ
진공펌프	真空ポンプ
통지하다	通告,知らせる
韓國	朝鮮
이메일	メール,Eメール,電子メール,イーメール
오케스트라	1. オーケストラ 2. オーケストラ,ōkesutora
파푸아 뉴기니	パプアニューギニア
군사 혁명	檄文,檄
따오기	朱鷺,とき
부룬디	ブルンジ
향유 고래	マッコウクジラ
피그미족	ピグミー
디저트	デザート
위장염	胃腸炎
분리성	溶解性
미국남동부의 주	テネシー,テネシー州
인류학	じんるいがく,人類学
형광등	蛍光灯,けいこうとう
힉위 증서	卒業証書,ディプロマ
협공저	共和,協働
버드나무	ヤナギ,柳
원추형	円錐
아주 싫은 것	憎しみ
풀기어려운	複雑
디젤유	ディーゼル燃料
선회하다	曲る
이발하다	理髪師,床屋,美容師
부르카	ブルカ
디젤차	ディーゼル燃料,軽油,ディーゼルエンジン,ディーゼル
코사인	余弦,コサイン
항상성	恒常性
자유분방	油断,過失,yudan,ゆだん
부메랑	ブーメラン
토지 관리인	不動産屋
비브라토	ビブラート
섬광전구	稲光,フラッシュ
출처가 의심스러운	うその,典拠が疑わしい
발음 구별 기호	ダイアクリティカルマーク
자웅 동화서	双成り
최후 통고	最後 通牒
이마뼈	前頭骨
변태의	異常な,不自然な
세발자전거	三輪車
올빼미 비슷한	ふくろう,梟,フクロウ
무기한으로	itsumademo,何時までも,いつまでも
영국에서는 약4	ガロン
합성기	シンセサイザー,音源
107번 원소	ボーリウム
위원장	議長,委員長,主席
품행이 좋지 못함	文法違反
들치기	万引,manbiki,まんびき
중세 고지 독일어	中高ドイツ語
피우다	1. 飲む 2. 飲む
약한 지진	振戦
알프스 산맥	アルプス
체조교사	体操選手
자매의	姉妹
광장공포증	広場恐怖症
히브리의 예언자	オバデヤ書
소크라테스	ソクラテス
정사각형	正方形
어스레함;회색	灰色
피오르	フィヨルド
카나리아 제도	カナリアス諸島,カナリア諸島
유입점	ryūnyū,りゅうにゅう,流入
아야톨라	アヤトラ
학살하다	謀殺する,殺害する,殺す
순리적으로	いつもは,俗,通常,tada,何時も,一般に,日頃,大抵,普通に,ただ,いつも
순종하는	従順な,従順,忠実な,忠実
하숙집	宿舍
일벌레	働き者
학자연하는 사람	衒学者
코브라	コブラ
프로그래밍 언어	プログラミング言語,計算機言語
입문서	いろは
일반인	人民,市民,国民,公民,民衆,臣民,民
香港	中華人民共和国香港特別行政区,香港,ホンコン
보청기	補聴器
용해제	溶媒
발랄라이카	バラライカ
왕굴나무	ブンタン
유용한	1. かちたかい,価値高い,kachitakai,貴重,大切な 2. 便利な
음성학	音声学
분리한	慎重
빨강모자 소녀	赤ずきん
인정받지 못하는	同一の,一卵性の
유일량	ryūnyū,りゅうにゅう,流入
혈거인	穴居人
콧대를 꺾어 놓다	おがくず
고유 명사	名前,固有名詞
실례되는말	文法違反
유원지	遊園地
대장장이	鍛治屋,蹄鉄工,鍛冶屋
유월절	過越
용해성	溶解性
음소의	音韻論
육욕의	官能的
데모크리토스	デモクリトス
건조하다	乾く,乾かす
마그나 카르타	マグナ・カルタ
장미꽃밭	ロザリオ
말라리아	マラリア
우편환	かわせ,為替
재떨이	灰皿
한센병	天刑病,癩病,ハンセン病
유용성	ユーザビリティ
장미나무	bara,ばら,薔薇,バラ
가신의 신분	しんじゅう
바다코끼리	セイウチ
음소론	1. 音韻学,音韻論 2. 音韻論
까는 모피	カーペット,絨毯
자르다	1. 切る 2. 切る 3. 切り離す,切断,切断する
유연한	軽い
입맞춤	平和
엄지손가락	親指
필수 아미노산	必須アミノ酸
햄버거	ハンバーガー
핵분열	核分裂
자유무역	自由貿易
불명한	疑わしい
루마니아의수도	ブカレスト
탈환하다	取り戻す
쿼크모형	クォーク
슬라브 사람	スラブ人,スラヴ人
...에 관계없는	とも,……とも,いいえ
風水	風水
이발사	1. 理髪師,床屋,美容師 2. 床屋,美容師
자료부	霊安所,遺体安置所
특별한 방법으로	1. 特別,特殊に,特別に 2. 特別,一入,ひとしお,別段,特殊に,特別に
보청의	アコースティック
엘리자베스1세	エリザベス
마개뽑이	コルクスクリュー
불면증	不眠症,不眠
직접적으로	近く
산발적인	散発的
사납게몰아치는	賑やかな
접는식의 유모차	乳母車,ベビーカー
유기적 조직체	生物
분명함	あきらか
자비롭게	人道的に
뺑소니치다	散歩する
불명예	1. 羞恥心 2. 羞恥心
매혹하는 사람	魔法使い
오늘저녁	今晩,今夜
버펄로	バッファロー
점강음	crescendo,クレシェンド
뉴욕 시	ニューヨーク州,ニューヨーク市,ニューヨーク,紐育
역사적으로 유명한	祝われた
전구증	徴候,前駆症状
콩소메	コンソメ
약종; 약물학	薬理学,薬学
붉은 빛을 띤	赤,サクランボ色,性的にみだらな
햄스터	ハムスター
알아보다	認める
셰익스피어	シェイクスピア
불도저	ブルドーザー
가청전파	分光特性,スペクトル
부등식	不同,不平等
주소 성명록	ディレクトリ
인칭 대명사	人称代名詞
너무 익힌	無理な,誇張された
뉴욕 주	ニューヨーク州,ニューヨーク
크림반도	クリミア
저금통	1. 貯金箱 2. 貯金箱
열중시키는	熱心な
절대적인 진리	福音書,ゴスペル
격리 병원	ハンセン病療養所
허리통	胴回り,ウエスト,胴のくびれ,腰
실험용 언어	メタ言語
장려한	素晴らしい,subarashii,見事,素晴しい,立派な
임계 질량	臨界質量
가르치는 사람	教師
프라이버시	ひみつ,秘密,グライバシー
하이쿠	俳句
방글라데시	バングラデシュ
친할아버지	外祖父,祖父,そふ,お爺さん,おじいさん,sofu
뇌척수액	脳脊髄液,髄液
숨막힐듯한	mushiatsui,蒸し暑い,むしあつい
젓가락	割り箸,箸,おてもと,はし,菜箸
돛이 거꾸로	1. 後方 2. 後方
역전할수 없는	不可逆な
12세인 성인	頓痴気,低能者,間抜け,baka
용적 톤수	トン数
알제리의 수도	アルジェ
복어류	鰒,河豚,フグ
적나라한	裸の,裸
산을 내는	酸性の,酸性
자비로운	1. 慈愛深い 2. 慈悲深い,慈愛深い
성애를다룬문학	ポルノグラフィー,猥褻,ポルノ,エーブイ,猥本,アダルトビデオ
카주피리	カズー
음식의	栄養素
(Hawai)	ハワイ州,ハワイ諸島
쿠데타	乗っ取り,謀叛
일부러	故意,故意に,わざと,意識的な,態と
시시한 인간	青二才
파로스어	フェロー語,ファロエズ語
자명종	目覚し,目覚まし時計
벨크로	面ファスナー,ベルク
전격전	電撃戦
코알라	袋熊,コアラ
장례식	葬式,葬儀
음식점	レストラン,食堂
균형잡힌	対称な
잔물결	波紋,ウェーブレット
경쟁하다	競争する,争う,張り合う
일정 불변	画一性,統一性,普遍性
거주하다	住む
파푸아뉴기니	パプアニューギニア
보이다	見せる
일본해	Nihonkai,日本海
부스러기	もつ,臓物
보일러	ボイラー
볼연지	頬紅
합성하는 사람	シンセサイザー,音源
입법부	1. 立法府 2. 元老院
유전형	遺伝子型
우회로	迂回路
동물행동학	動物行動学
후천성면역결핍증	エイズ,後天性免疫不全症候群
유전학	遺伝学,遺伝的特性
유유히	故意,故意に,わざと,意識的な,態と
입방근	立方根
알았습니다	必ず,zehi,正に,是非,その通り,屹度,実に,確かに,確実に,きっと,ぜひ
콧수염	鬚,口髭,髯,口ひげ,髭
바스티유 감옥	バスティーユ牢獄
유일한	唯一
니기미 씹할놈	くそったれ
의성어	擬音語,ぎおんご,擬声,オノマトペ,擬声語,擬声擬態語,擬音
지렁이 양식	バーミキュライト
유전자	gen,遺伝子,いでんし,idenshi
별거수당	別居扶助料
아나콘다 뱀	アナコンダ
일본어	日本人,日本語
자유사상	理神論
이탈자부리파	分離主義者,分離独立
하와이	ハワイ州,ハワイ諸島
이사회	元老院
들쥐류	畑鼠,ハタネズミ
시계풀의 열매	パッションフルーツ
재무관	会計係
방귀뀌다	屁をこく,放屁,屁をひる,放屁する,おならをする
이상화	昇華
밀크셰이크	ミルクセーキ
이상한	1. 奇妙な 2. おかしい,乙,変な 3. 不気味な
마력있는	マジック
복잡성	複雑さ
디스켓	フロッピィ,フロッピーディスク,ディスク,ディスケット
인삼속	オタネニンジン
긴급출동부대	消防隊
불사하는	不滅
필적학	筆跡学
항구 도시	ベリーズ
연료 주입구	防火扉
광광 여행	観光
인쇄기	印刷業者
시트론껍질	1. シトロン 2. シトロン
인쇄공	印刷業者
미국 북서부의 주	ワイオミング州,ワイオミング
버들개지	尾状花序
사이안화 수소	シアン化水素
베트남	ベトナム
일사병	日射病
병참술	物流,運送,兵站,butsuryū,ぶつりゅう
자유 에너지	エネルギー
정규의	常態,正常
음운론	音韻学,音韻論
효소 분해	発酵
웃으며 ...하다	笑う,笑い飛ばす,一笑に付す
코소보	コソボ,コソヴォ
점근선	漸近線
장미덤불	bara,ばら,薔薇,バラ
복음서	福音
고대 영어	1. 古英語 2. 古英語 3. 古期英語,古英語
부뚜막	囲炉裏,暖炉,だんろ,danro
보육원	保育所
베토벤	ベートーベン
단편소설	短編小説
음악학	音楽学
한여름	真夏
정규로	いつもは,俗,通常,tada,何時も,一般に,日頃,大抵,普通に,ただ,いつも
소리치다	1. 歌う 2. 叫ぶ 3. 叫ぶ
이상의	異常な,不自然な
인서기	印刷業者
매력있는 사람	魔法使い
원하다	希望する,望む
은유의	比喩,比喩的な
오페레타	オペレッタ,喜歌劇,軽歌劇
감동시키는	辛辣な,痛切な,痛烈な
보호하지 않은	明確な,明確
전기판	決まり文句
양털 모양의 침전	凝集
틀린생각	誤謬
제곱근	平方根
해시계	日時計
여자12~21세	青年期,青春
인사과	人事部,人事課
바퀴달린 의자	車椅子
정관사	定冠詞
인상주의	印象派
본 뜨는 공구	雛形
털어놓다	現す
부럽다	羨ましい
필요한	必要な
민주적으로	民主的に
정강이	脛,臑
어휘 항목	語彙素
전기의	シビレる,エレクトリック,電気的な,電動の
기관지염	気管支炎
벌하다	懲罰する,ばっする,制裁する
정각에	1. 早々,早速 2. 早々,早速
피제수	被除数
따분한	退屈な
보조물	子会社
수에즈 운하	スエズ運河,スエズ地峡
잡목숲	雑木林
정거장	警察署
해석학	解釈学
보조자	子会社
장마철	雨季,雨期
원자력 전기	原子力
제정신의	バランスの取れた,常識のある
냄새 맡는 약병	ヴィネグリットソース
적포도주	赤葡萄酒,赤ワイン
정신 착란의	気が狂った
긴 프록코트	アルベルト,アルバート
사전 인지	予知
탄화칼슘	炭化カルシウム
운좋은	幸福な
원예가	庭師
원앙새	オシドリ
사나운비바람	荒れ,are,嵐
쬐어지다	炙る
존재에 관한	存在的
우주의	空間的
우주선	1. 宇宙機,宇宙旅行船,宇宙船 2. 宇宙機,宇宙旅行船,宇宙船
비만한	肥満
추구하다	求愛,求愛する
앤솔러지	アンソロジー
율법학자	ラビ
비디오 카세트	ビデオカセット
자기력	磁性
유방암	乳癌
원예사	庭師
오아시스	避難所,オアシス
웃으운	1. かたはらいたい,馬鹿らしい,kataharaitai,片腹痛い,馬鹿な 2. 馬鹿らしい 3. 馬鹿らしい
투표용의 작은공	投票用紙
유미즙	糜粥
표준시	ひょうじゅんじ,標準時間,ひょうじゅんじかん,時
생물상호작용	共和,協働
저음의나팔통	スーザフォン,チューバ
썩  좋은것	ピザパイ,パイ,ケーキ
자기장	磁場,磁界
섭외 사무	パブリック・リレーションズ,PR,ピー・アール
통나무 벌채	伐採
연애 유희	軟派
웰쉬어	1. ウェールズ語 2. ウェールズ語
여자 실업가	女性実業家
향수 박하	レモンバーム,西洋山薄荷
비망록	忘備録,メモ
진지하게	真剣に,切実に,真面目に
뇌하수체	下垂体
불쾌히	声を出して,大声で
불쾌한	1. 嫌 2. くだらない 3. 憎い
자기학	磁性,磁気
인도마마	フランベジア
탄알을 빼내다	降ろす
유별한	1. 取り合わせた,雑多 2. 取り合わせた
콜히친	コルヒチン
罪人	1. 罪人,犯人 2. とりこ,hitoshichi,人質,ひとしち
타로토란	里芋,サトイモ
압하스어	アブハズ語,アブハジア語
와이오밍 주	ワイオミング州,ワイオミング
장광설	失禁
비만증	1. 肥大,肥満 2. 肥満,kajū
포어성 동물	漁師
비막이	日陰,日よけ
선 자세	見得
인원수 세기	人口調査,戸籍
돼지기름을 바르다	ラード
게걸스러운	熱心な
중세 영어	中期英語
팝 음악	ポップ,ポップ・ミュージック
美國	亜米利加,アメリカ大陸,アメリカ州,アメリカ合衆国,アメリカ,米国
한 통의 양	バケツ
망고스틴	マンゴスチン
화화한 겉치레	もんしょう,紋章
숨김없는	明晰な
육분의	六分儀
위선자	偽善者,ぎぜんしゃ,gizensha
상관 대리	中尉,副官,少尉
카탈루냐 지방	カタルーニャ,カタロニア
이제부터는	1. 前へ 2. 今後,今や,これ以後
컴프레서	圧縮
외톨이	ひとり
원자로	原子炉,反応器
단선율의	モノ
월요일	月曜日,getsuyōbi
원자력	1. かくほゆうこく,kakuhoyūkoku,核保有国,原子力 2. 原子力
프놈펜	カンボジア,プノンペン
하기)	連音
빠른맥	頻脈
불평등	不同,不平等
자동 변속 장치	オートマチック
투표용지	1. 投票 2. 投票用紙
스튜 냄비	鍋,ソースパン
삼단 논법	三段論法
거죽만의	表面上
퀸즐랜드	クイーンズランド
지체 높음	hitogara,ひとがら,人柄
폭풍우	1. 荒れ,are,嵐 2. 嵐 3. 嵐
보좌 신부	牧師
포플라	ポプラ
단풍나무속	かえで,カエデ
胎兒	胎児,胎兒
원일점	アプス,長軸端
원자의	原子
초현실주의	超現実主義,シュルレアリスム
위생학	衛生
교구위원	所長,看守
음료수	飲用水,飲料水
갑상선저하	甲状腺機能低下症
요크가	ヨーク,ヨーク家
이따금	時々,時時,ときどき,tokidoki
식세포 작용	食作用
콤펙트	パンケーキ
원조자	助手
재규어	パンサー,ジャガー,ヒョウ,ピューマ,豹
인두세	人頭税
공공 토목 공사	公共事業
에우로파	エウロパ
태평스러운	のんきな
외판원	店員
냄새 자국	フラストレーション,障害物
스페인말의 혼합어	共通語,リングワ・フランカ,リンガフランカ
인민당원	民主党支持者,民主主義者
인도양	インド洋
잔재주 있는 사람	広く浅く,万屋
우편 엽서	葉書,hagaki,はがき
우체국	ゆうびんきょく,yūbinkyoku
아라스천	タペストリー
때로는	時々,時時,ときどき,tokidoki
숨김없이	正直に
소산하다	吐き出す
의붓 딸	継娘
칼리포르늄	カリホルニウム
조심스럽게	じっくり,丹念に
탕가니카 호	タンガニーカ湖,タンガニーカ
육두구의 씨	ナツメグ
빠르기	そくど,速さ,速度
피고인	被告
관상대원	天気予報係
표절물	盗作,剽窃
현미경의	マイクロスコープ,顕微鏡
마이애미	マイアミ
카르나타카 주	カルナータカ州,カルナータカ
우체부	郵便配達人
十二月	師走,じゅうにがつ,十二月,12月
...의 대신에	...の代わりに,代わり
건강해 보이는	美しい
인두염	咽頭痛
핀란드 만	フィンランド湾
원주민	原住民,アボリジニ
코홀즈	コルホーズ
공포정치	テロリズム,テロ
위스키	ウィスキー,ウイスキー,uisukī
음모단	秘密結社
지금까지	これまでのところ,これまで,今まで
한국어	韓国語,朝鮮語
프라하	プラハ
정신병 의사	精神科医,精神医学者
통화 공급량	マネーサプライ
알렉산드리아	アレクサンドリア
타산적인	計算高い,keisandakai,けいさんだかい,計算可能な
말라얄람어	マラヤーラム語
원주필	ボールペン
플래시	ランタン,提灯
백발이 섞임	灰色
때때로	1. 時々,時時,ときどき,たまに,tokidoki 2. 時々,時時,ときどき,tokidoki
胎盤	胎盤
국민학교	しょうがく,学校,小学校,しょうがっこう,shōgakkō
가니메데	ガニメデ
남미의공화국	ボリビア
복장 도착자	異性装者
불충실	不忠実
애보카도	アボカド
컴퓨터 프로그래밍	プログラミング,番組
오시비엥침	アウシュビッツ,オシフィエンチム,アウシュヴィッツ
헤너 머리 염색제	ヘンナ
쾌활한	快活な
쾌활함	だんせい,弾性,柔軟性,弾力性
푸주한	肉屋
크바스	クワス
근본주의	根本主義
영양이 되는	栄養素
十一月	十一月,１１月,じゅういちがつ,霜月,11月
잘 지껄이는	おしゃべり好きな
보조 정리	補題
소프트웨어 엔지니어	ソフトウェアエンジニア,プログラマー,ソフトウェア開発者
가는사람	とぎ器
프로판	プロパン
프로톤	陽子
의붓 형제	たねちがい,胤違い,異父母兄弟
니코시아	ニコシア
안녕히 주무십시오	おやすみなさい
보이지 않	見えない
크립톤	クリプトン
안녕히 주무십시요	おやすみなさい
돼지우리	豚舎
오트볼타	ブルキナファソ,オートボルタ
권위주의의	独裁的な
오스트레일리아	1. オーストラリア人,オージー 2. Ōsutoraria,オーストラリア大陸,豪州,濠洲,オーストラリア,豪,オーストラリア連邦 3. オーストラリア大陸,オーストラリア
카트만두	カトマンズ
크리크	小川,流れ,入江,いりうみ,いりえ,入海,川,irie,iriumi
합격한	幸運な,成功した,成功裏の
실격시키다	無効にする,無力化する
臺灣	臺灣,たいわん
유속계	回転速度計
유산아	人工流産,妊娠中絶,中絶,人工妊娠中絶
퇴관하다	辞職する,辞任する,辞める,退位する
유선염	乳腺炎
태극권	太極拳,太極
확실하게 하다	証明する
확대 가족	大家族
사담 후세인	サッダーム・フセイン
프리온	プリオン
헬리콥터 발착소	ヘリポート
뛰어난 기억력	忍耐,堅持
웨이터	1. ウエーター 2. ウエーター 3. ウエーター,ウエイター 4. ウエーター,ウェイトレス,ウェートレス,ウエイトレス
항공술	宇宙航行学
낚시밥용지렁이	蚯蚓,ミミズ
사춘기에 이름	思春期,破瓜,青春期
태권도	格闘技,テコンドー
눈치빠른	眩い,kawaii,ﾓｴ
해결법	出口,解決法
보석의 원석	宝石
가다랑어	カツオ
움직이다	1. 行く,死ぬ 2. 死ぬ,あげる 3. 傾く
유성음	有声音
자동사	自動詞
외향성	外向性
유성체	流星
터무니 없는	かたはらいたい,馬鹿らしい,kataharaitai,片腹痛い,馬鹿な
수정하다	適応する
필기자	syoki）,書記
죽은 뒤에	死後
클로버	クローバー
메티오닌	メチオニン
트림하다	げっぷ,噫気する,げっぷする,うっぷ,うっぷする,おくび,噫気,おくびする
깍지를 먹는콩	莢豌豆
위안부	慰安婦,従軍慰安婦
자동차	乗用車,車,四輪車,kuruma,自動車,くるま
의문문	尋問
학개서	ハガイ書
필기체	草書
깜짝 놀라다	後方
크루프	尻,ケツ
종으로 연결한	垂直の,直立,直立の,縦の,縦
척추 동물	脊椎動物
못 본체하다	ハゼ,鯊,沙魚
의무실	病院
자루 걸레	モップ
탐구자	探検家
이라크	イラク
거저 먹기	ピザパイ,パイ,ケーキ
배분하다	取り置く,配置する
이력서	履歴書
국민투표	1. 国民投票,レファレンダム 2. 国民投票,レファレンダム
어찌할 도리 없는	心細い
박수갈채	拍手
빨리빨리	さっさと
독일 사람	1. ジェリー 2. ドイツ人,独語,ドイツ語,ドイツ
땅돼지	アリクイ,ツチブタ
비능률적인것	不能
의미론	セマンティック
맹견의 일종	マスチフ,マスティフ
마음씨 고운	親切,心の優しい,優しい
진심어린 언동	こんせつ,konsetsu,懇切
크로뮴	クロム
이루다	達成する,収める,成し遂げる
크롬렉	支石墓
섬유 광학	ファイバー光学
아이스박스	冷蔵庫
한 지방의 특유성	固有種
남자 이름	1. エイブラハム・リンカーン 2. ウリヤ 3. アンドリュー,アンデレ,アンドル
피난민	難民
황폐케하다	壊す
다이아몬드	ダイヤモンド
움라우트	分音符号
쿠션 먼저 치기	トレビュシェット
크레용	パステル,クレヨン
유순함	法令遵守
유순한	従順な,従順,忠実な,忠実
이집트 아랍 공화국	エジプト
자기 만족의	ひとりよがりの
카람볼라	スターフルーツ
마이소르	カルナータカ州,カルナータカ
실력사회	能力主義
살아남다	ある,いる
프란슘	フランシウム
싸고야한 옷	バガテル
불운하게도	ainiku,残念,生憎
프랑슘	フランシウム
프랑스	フランス
잡다한	取り合わせた,雑多
이르다	1. 達成する,収める,成し遂げる 2. える,得る,手に入れる,買う,成し遂げる 3. 成し遂げる
동물학자	動物学者
나이지리아	ナイジェリア
실제적임	実用主義
따라서	したがって
???스	?リ?ス
보르네오 섬	1. ボルネオ島 2. ボルネオ島
아일랜드 해	アイリッシュ海
탐이나서 안달하는	痒い
토라지다	叱る,しかる
고혈을 빠는 사람	蛭,ヒル
이리듐	イリジウム
메가헤르츠	メガヘルツ
큰 소리로	1. 声を出して,大声で 2. 声を出して
저녁식사	夕食
제재소의	ニガー,黒いやつ
비단의	subesube,すべすべ
오트밀	オートミール
제일윗층	屋根裏部屋
불가결한 것	nyūyō,ひつよう,入用,にゅうよう
마술을 쓰는	マジック
애완 동물	そば
우주기원론	宇宙論
축구경기자	アメリカンフットボール,サッカー,アメフト
블루머	ズボン,パンツ
육두구	ナツメグ
동기를 주다	動機を与える
100분	パーセント,百分率
비단뱀	ニシキヘビ
오리사 주	オリッサ州,オリッサ
네모 팽이	独楽
콘택트 렌즈	コンタクトレンズ
유대풍	ユダヤ教
아라비아	アラビア
듣기좋은음조	音楽
붕장어	アナゴ,穴子
사과나무	林檎の木,リンゴの木
경제학자	エコノミスト,経済学者
잔업 시간	残業,オーバータイム
기호 논리학	数理論理学
블랙홀	ブラックホール
아카시아	1. アカシア 2. アカシア
비능률	不能
하누카	ハヌカ,ハヌカー,ハニカ
브뤼셀	ブリュッセル
협 박	脅迫
음극선	電子ビーム
유니콘	ユニコーン,一角獣
면회할 수 있는	1. 見える,目に見える 2. 見える,目に見える
유대인	ユダヤ人,ヘブライ語
소프트웨어	プログラム,ソフト,ソフトウェア,ソフトウエア
블로그	ブログ
마루깔개감	カーペット,絨毯
남자 친구	kare,カレ,カレシ,kareshi,かれし,ボーイフレンド
성나게하다	騒がす,いらいらさせる,苦しめる,煩わす
브로치	ブローチ
이의를 말하는	ベタベタする
대중교통	公共交通機関
십자가에 못박음	はりつけ
피라미	ヒメハヤ
미국 중북부의 주	ウィスコンシン
요오드	ヨードチンキ,ヨウ素
박싱 데이	ボクシング・デー
알랑거리다	お世辞を言う,諂う
웁살라	ウプサラ
반주 없게	アカペラに
마호메트교	回教
피란드	北欧諸国,フィンランド
약한 맥주	蛇足,バガテル
우습다	可笑しい
오페라	1. オペラ,オペラハウス,歌劇場 2. オペラ,歌劇団
느헤미야느헤미야서	ネヘミヤ記
유두종	乳頭腫
웰링턴	ウェリントン
유독한	害する,損なう
브로민	臭素
요약본	剥奪,凝縮,要約
웜바트	ウォンバット
콜카타	コルカタ,カルカッタ
저널리즘	報道,ジャーナリズム
운성체	流星
부주제	家父長制
교정하다	校正する,校正
존경을 얻다	なだめる
트리폴리	トリポリ
의의에 관한	セマンティック
불이행	油断,過失,yudan,ゆだん
부족한	ごく僅かの
위령곡	死者のためのミサ,鎮魂歌
소생하다	1. 起こす 2. 蘇らせる
건강에 좋게	健康的に,健康に
코페르니쿠스설	地動説
친척등용	ネポティズム
그 열매	1. クランベリー 2. 唐辛子,パプリカ
명백하지 않은	あいまいな
비등점	沸点
당좌 예금	銀行口座
빗대는	皮肉な,風刺的な
아제르바이잔	アゼルバイジャン
에이브러햄 링컨	エイブラハム・リンカーン
정성들여서	1. じっくり,丹念に 2. じっくり,丹念に
인색하다	そろばんだかい,算盤高い,sorobandakai
공격으로 나오다	攻撃する
재투성이의	青ざめた
고기 베는 큰 칼	包丁
수영 모자의 일종	マーモット
勿忘草	勿忘草
돌연변이	1. 突然変異 2. 突然変異体,突然変異
1)단축하다	短縮する,縮む,略す,省略する
플루트	1. フルート,横笛,笛 2. 笛
우슬초	綿棒
테러 행위	テロリズム,テロ
나그네비둘기	リョコウバト
항균성	抗菌性
풍족한	豊かな
와이오밍	ワイオミング州,ワイオミング
예언 능력	予言
응급치료	救護,応急措置,救急
코카인	コカイン
연락 도로	出入用道路
키스 병	伝染性単核球症
우수한	優れた,妙な,りっぱな,立派な,優良
고무적인	こころづよい,心強い
항공학	宇宙航行学
등마루	背中
아열대의	亜熱帯の
색소결핍증	アルビノ
이교도	1. 異邦人,不信者 2. キリスト教徒,クリスチャン
근본적인	基本
의심할 나위 없이	必ず,確かに,きっと
유량계	雨量計
어둠 속의	暗い
일각수	ユニコーン,一角獣
비둘기	1. ハト,鳩,hato 2. 鳩 3. 鳩
에게 해	エーゲ海
하노이	ハノイ
돼지 인플루엔자	豚インフルエンザ
몹시 탐내는	羨ましい
차입하고	貸付け,ローン
헤르니아	ヘルニア,脱腸
간접 공격	トレビュシェット
우주의 발생	宇宙論
붙임표	ハイフン
몬로비아	モンロビア
그리스의비극시인	エウリピデス
크로커스	サフラン
두름성 좋은 사람	管理者,支配人,ディレクター
괜찮습니다	感謝する
군사적 입장에서	軍事的に
수프 스푼	散り蓮華,散蓮華
아이슬란드	1. アイスランド,Aisurando 2. アイスランド,あいすらんど
슬로바키아	スロヴァキア,スロバキア
드물게	稀に
봉하다	立ち込める
집중 폭격하다	飽和させる
원수님	陸軍元帥
구름이 많은	くもり,(kumori)
이글루	イグルー
비꼬는	辛辣です
평온한 만년	小春日和
인과율	因果関係
인공의	人工的な,人工の,人為的な
이국인	1. 外人,外国人 2. 異人,外人,外国人,がいこくじん
인공어	人工言語
하늘나라	極楽,パラダイス,楽園,十万億土,rakuen,らくえん,天堂
반감을 가진	憎い
인도인도	バーラタ,インド,印度
새끼 고양이	子猫
용연향	龍涎香
마샬 군도	マーシャル諸島共和国,マーシャル諸島
하라레	ハラレ
머리털이 있는	毛深い
속도 위반 딱지	クリスマス・カード
불모로 하다	殺菌する
에멜무지로	一応
사람을 괴롭히는	熱心な
음성사론	音韻学,音韻論
부엉이	ふくろう,梟,フクロウ
뇌를 쓰다	考える
발생기원	ご降誕,御降誕,生誕,出産,降誕
해금하다	合法化する
죽음의 무도의	身の毛もよだつ
쌍무적인	相互的な,双方
미치광이	変な人
요점은	1. 中々,実質的に,なかなか 2. 実質的に
원산종	原住民,アボリジニ
항독소	抗体
개구리 헤엄	平泳ぎ
하르키우	ハルキウ
수치스러운 행위	羞恥心
딱꾹질	shakkuri,しゃっくり
에피루스	イピロス,エピロス,エペイロス
용어집	語彙
목로술집	酒場
들리다	聞く
서정시인	作詞者,作詞家,さくしか,さくししゃ
실레지아	シレジア
언어 분석용 언어	メタ言語
은화 식물	隠花植物
온화한	愛想のいい
도량형학	測定学,度量衡,計測学,計量学
덴마크어	1. デンマーク語 2. デンマーク語
원심력	遠心力,えんしんりょく
머리카락	1. たてがみ,毛,髪,鬣 2. 毛
믿을수 있음	信用性,真実性
우연한	偶然
필리핀	1. フィリピン 2. フィリピン,フィリピン共和国
보호자	保護者,係員
유로퓸	ユウロピウム
비교의	深遠な,秘儀の,奥義の,秘密の
비교적	比較的,比較的に
실업 상태	失業
별자리의	1. 恒星の（こうせいの,星の 2. 恒星の（こうせいの,星の
이체 동형	準同型
스코트어	スコットランド語
코프라	コプラ
용적량	トン数
보복적 포획	ふっきゅう,復習
임계점	臨界点
말라깽이	かかし
시사회보	ニュースレター,かいし,kaishi,会誌
허수 부분	虚数部,虚部
불안감	予感
북엔드	ブックエンド
討論	論争
은둔자	仙人,世捨て人
비겁한	臆病な
상습적인	慢性的な
과소 평가하다	過小評価する
딸꾹질	shakkuri,しゃっくり
해돋이	akegata,暁,夜明け,あけがた,明け方
해독제	解毒剤
루마니아어	1. ルーマニア語 2. ルーマニア語
누악쇼트	ヌアクショット
비구름	雨雲,後光
마약 중독자	ジャンキー,麻薬常習者,麻薬中毒者
슈퍼마켓	1. # 食料雑貨店,食料品店 2. スーパーマーケット
욕지기	吐き気
볼프람	タングステン
한란계	温度計
우아한	1. 典雅な 2. 女らしい,おんならしい
탄생시의 별 위치	ホロスコープ
모음 변이	分音符号
비비꾄 목걸이	トルク,toruku
열대 다우림	雨林,熱帯雨林
오히려	ふと
분압기	ポテンショメータ
피부병학	皮膚科学
요즈음	最近,さいきん,saikin
부끄럽게 하다	困らせる,狼狽
무력하게 하다	無効にする,無力化する
기계적 방법	暗記学習
연주 대	キオスク
우익수	ライト,右翼手
스튜어디스	乗務員
작곡가	作曲者,sakkyokuka,さっきょくか,作曲家,さっきょくしゃ,sakkyokusha
그 수도	サンマリノ,サン・マリノ
비난의	批難,非難
부족액	不足
북조선	北朝鮮,朝鮮民主主義人民共和国
휩쓸어 넣다	合同
미뉴에트	メヌエット
아칸어군	アカン語
드로즈	ズボン,パンツ
바베이도스	バルバドス
브라질	伯剌西爾,ブラジル
고약한 냄새	悪臭,臭い
히스테리의 발작	癇癪
핀란드	北欧諸国,フィンランド
뇌신경세포	脳細胞
어머니 같은	母方の,母性
몹시 알랑대는	ごますりの
건량의 단위	クォート
분점년	太陽年
상파울루	サンパウロ市,パウロ
일기장	日記
외치다	1. 叫ぶ 2. 叫ぶ 3. 叫ぶ 4. 叫ぶ 5. 叫ぶ 6. なる
브랜디	ブランデー,コニャック
이스라엘 사람	イスラエル人
그 상의	タキシード
부인회	姉妹
우유술	馬乳酒,クミス
우인론	時折の,偶発的,偶然な,偶,時折
말라기서	マラキ書
로제타석	ロゼッタ・ストーン
와이셔츠	シャツ,Ｔシャツ
우유점	酪農場,牛乳屋,牛乳販売店,日用雑貨店,牧場
하드론	ハドロン
유감스러운	悔しい
유행성 이하선염	流行性耳下腺炎,おたふく風邪
약한 사람	弱虫
부적격	不可
유물론	唯物論
운전사	運転手
유모차	乳母車,ベビーカー
불완전	不完全
향고래	マッコウクジラ
불구자로 만들다	不具,不具にする
세인트 마틴	セント・マーチン
유명한	有名な,nadakai,なだかい,名高い,高名な,有名
그렇지 마는	やはり,しかも,それにもかかわらず,それでも
자기권	磁気圏
목재 펄프	パルプ
우주론	宇宙論
에드먼턴	エドモントン
으뜸패	きりふだ,切り札
제멋대로의	自分本位の,利己的な,わがままな,身勝手な,勝手な
자궁전	絞り
필란드의 수도	ヘルシンキ
부자인	金持,金持の,富有な,裕福,富有,裕福な,豊か
부유한	金持,金持の,富有な,裕福,富有,裕福な,豊か
자역하다	字訳
건강하여	健康的に,健康に
니콜라스	ニコラス
허드렛일	雑用,任務,雑務
몰인정한	kokuhaku na,非人道的な,酷薄な,こくはくな
보기에 즐거운	官能的な,肉感的な,豊満な
최저음의 종	バグパイプ
땅거미	黄昏,薄明,日暮
불안한	不安な
음소론의	音韻論
알래스카 주	アラスカ州
변덕스러운	不定な
표에 올리다	計画,議事,日程
고문체의	初期,古風な
전자 레인지	チン,電子レンジ,電子レンジオーブン,マイクロ波
여가장제	家母長制
비상한 통찰력	透視
노스다코타	ノースダコタ
국제 연합	国際連合
원자폭탄	原爆,原子爆弾
가늘고 긴 쌍날칼	レイピア
윤리학	倫理,倫理学
차 마시는 시간	珈琲
크레타섬	クレタ島
완전히	1. marude,丸で 2. marude,全く,まるで,全て,丸で
공식 발표	コミュニケ
滑車	滑車
濠洲	Ōsutoraria,オーストラリア大陸,豪州,濠洲,オーストラリア,豪,オーストラリア連邦
플루토늄	プルトニウム
유기의	有機
공로마일	海里,マイル
뒷발의 엄지발가락	足指,つま先
너무쓰다	過ぎる
에머랄드 섬	アイルランド,Airurando
장식주름을 내다	仕事着
캔버라	カンベラ,キャンベラ
배가 다른 형제	たねちがい,胤違い,異父母兄弟
그 결과	従って,ですから
우발성	成功報酬
펨토 미터	フェルミ
메탄 열	アルカン,パラフィン
복잡한관계	迷路,迷宮
유기체	生物
저쪽으로	あそこへ,そこへ
말 안 듣는	頑固な
무지개 송어	マス,虹鱒,ニジマス,鱒,(masu)
네크리스	首飾り,ネックレス
식료품류	# 食料雑貨店,食料品店
원로원	元老院
측지학	測地学
왕자비	ひめ,ōjo,姫,王女,hime,おうじょ,王妃
혈액학	血液学
비참한	こころぼそい
습기 있는	湿っぽい
火星	火星
우발의	偶然的な
호색가	助け平
예외적으로	特別,特別に
완전론	完全主義
데시리터	デシリットル
현악기	ヴァイオリン,バイオリン
내분비물	ホルモン
카사바	キャッサバ
손으로 치기	手錠
폴리우레탄	ポリウレタン
외손자	孫息子
고대 프랑스말	古フランス語
불가능하게	無理に
그 가죽	鰐,わに,wani,ワニ
시장부인	市長
여우털빛의	巧妙な,狡い,ずるい,狡猾,悪賢い
석기 시대	石器時代
협심증	狭心症,きょうしんしょう
뉴잉글랜드	ニューイングランド
말벌의 일종	雀蜂,スズメバチ,モンスズメバチ
유체역학	水力学
화목한	なごやか
게으름뱅이	1. 怠け者 2. 怠け者
남작계급	かぞく
어셈블러	アセンブラ,asenbura
남자같은	1. 男性名詞,男性,男性的な,男の,男性の 2. 男性
규정항로	規定航路,細道,路地
남녀구별이 없는	無性の
유창하게	ペラペラ,ぺらぺら,さらさら,流暢に,すらすらと,さらさらと,ぺらぺらと
완전체	整数
침수한	浸水した
지능지수 50	頓痴気,低能者,間抜け,baka
안출하다	発明する
가연성의	可燃物
메틸알코올	メタノール
라크로스	ラクロス
전자 빔	電子ビーム
시체 공식소	霊安所,遺体安置所
귀머거리의	聾,聴覚障害者,耳の聞こえない,聾者
월드컵	ワールドカップ
쓸모없는 인간	怠け者
폴리에틸렌	ポリエチレン
용맹한	大胆な
카세트	カセット
아르메니아어	アルメニア語
진공관의 내파	爆縮
뺑소니	逃げる,nigeru）,失踪する
울리는	有声
울리다	歌う
다시팔다	転売する
예컨대	例えば,例,たとえば,tatoeba
무자격하게 만들다	無効にする,無力化する
河馬	カバ,kaba,河馬
마차 경주장	競馬場
외손녀	孫娘
좋아하지 않다	嫌う,憎む,いやである
무성음의	無声
호소학	陸水学
공격받기 쉬운	脆い,脆弱な,傷つきやすい
벨라루스	ベロルシア,ベラルーシ
여성 요트 조종자	ヨット乗り
내분비학	内分泌学
출생증명서	出生証明書
홀소리	母音字,母音
싸구려로	いつもは,俗,通常,tada,何時も,一般に,日頃,大抵,普通に,ただ,いつも
혈옥수	ニオイムラサキ,ヘリオトロープ,薄紫,キダチルリソウ
...을 단축하다	短縮する,縮む,略す,省略する
서류 가방	財布,ブリーフケース,鞄
혈액형	血液型
어휘소	語彙素
학술상의	科学的,科学的な
水素	水素,すいそ
뜻깊은	妊娠
긴급한 필요	nyūyō,ひつよう,入用,にゅうよう
오줌통	1. 膀胱 2. 膀胱 3. 膀胱
울레마	ウラマー
인간모양의 로봇	じんぞうにんげん,人造人間
혈우병	血友病
시트론의 열매	1. シトロン 2. シトロン
치와와	チワワ州
너털 웃음을 웃다	笑う
데바나가리	デーヴァナーガリー
양치는 여자	羊飼い
오징어	1. イカ 2. コウイカ 3. 烏賊,イカ
허둥지둥	きゅうきょ
호색의	1. 嫌らしい,エッチ 2. sukebe
요법사	カイロプラクター,カイロプラクティック
불깐 말	騸馬
회복되다	よくなる,改善する
어휘학	語彙論
아세트알데히드	アセトアルデヒド
냉동 커스터드	ソフトクリーム
얼음보숭이	アイスクリーム,aisukurīmu,アイス
예측된	作為的な,意識的な
화분증	花粉症
군사적으로	軍事的に
비전의	深遠な,秘儀の,奥義の,秘密の
벨라도나	ベラドンナ
완충기	クッション
오타와	オタワ
기똥차다	仰天するような
유대교	ユダヤ教
천문 단위	1. 天文単位 2. 天文単位
배양상의	文化的,文化の,文化的な
음계종	鉄琴
흩 뿌리다	種をまく
사형 집행실	舞踏場
불요 불굴	忍耐,堅持
껄껄 웃다	笑う
옥타브	オクターヴ
개구장이	エルフ
용수권	水力,すいりょく
뜨개질	裁縫
만족 시키다	満足させる,満足
놀라게하다	驚かす,仰天させる,驚かせる
치근치근한	ごますりの
비존재	否決
영화관	映画館
커피 콩	珈琲,コーヒー豆
준동형사상	準同型
쓰잘데 없는	くだらない
미크로네시아	ミクロネシア,ミクロネシア地域
유다서	ユダの手紙
닥스훈트	ダックスフント
연한 청색	緑柱石
원기회복	chōshū,ちょうしゅう,徴集
확성기	メガホン
유대류	有袋類
출생 증명서	出生証明書
형제의	兄弟
유달리	特別,一入,ひとしお,別段,特殊に,特別に
105번 원소	ドブニウム
간추리다	短縮する,縮む,略す,省略する
빠에야	パエリア
교구목사	牧師
간첩행위	スパイ行為
보통으로	いつもは,俗,通常,tada,何時も,一般に,日頃,大抵,普通に,ただ,いつも
유난히	特別,特別に
알츠하이머 병	アルツハイマー病
무료 고속도로	高速道路
이리 인간	狼男
고무도장	ゴム印
외설한 일	大便,くそ,うんこ,ふん,糞便
외양석	漂白剤
자랑하다	自慢する,力む
이탈리아어	1. イタリア語 2. イタリア語
성기상자	仮庵,幕屋,シナゴーグ
싱크로트론	シンクロトロン
떼어 놓다	やめさせる,乳離れさせる
가망없음	絶望,ぜつぼう,zetsubō
형용사	1. 形容詞 2. けいようし,形容動詞,形容詞,keiyōshi
여호와	ヤハウェ,エホバ
중성 주정	エタノール
크렘린 용어	クレムリ
영국령 버진 아일랜드	英領ヴァージン諸島,イギリス領ヴァージン諸島,イギリス領バージン諸島
혼성화	コラージュ
오크어	1. オック語 2. オック語
오탁물	汚染
스테레오판	決まり文句
마하라슈트라	マハラシュトラ州,マハラシュトラ
빗장뼈	sakotsu,鎖骨,さこつ
호스텔	ホステル,ユースホステル
우눈헥슘	ウンウンヘキシウム
홀수선	喫水線
빨간 잉크	赤字
손에 잡히지 않는	短命な,はかない,束の間の
오크라	1. オクラ 2. オクラ
언쟁 부분	懸賞付き競技
자랑하여	無益
서언하다	断言する
정원 꾸미기	庭いじり
경영권 취득	乗っ取り,謀叛
월드 와이드 웹	ワールド ワイド ウェブ,ウェブ,WWW,ワールド・ワイド・ウェブ
火鍋	火鍋
몽유병자	睡眠時遊行症
속도 기록계	回転速度計
타마린드	タマリンド
열하나	1. 十一 2. 十一
서양호박	zukkīni,ズッキーニ
비우다	1. 尽くす 2. 避難する
정력적인	さかん
독재자의	独裁的な
후두염	喉頭炎
비올라	1. ヴィオラ 2. ヴィオラ・ダ・ガンバ,ヴィオラ 3. ビオラ,ヴィオラ
독재정부	1. 専制政治,独裁政治 2. スターリニズム,独裁政治,幕府,bakufu,独裁 3. 独裁政治
섬유아세포	線維芽細胞
여행사	旅行の代理店,旅行会社
연속적으로	連続的に
친절히	親切に
위대한	強大
가끔하는	時折の,偶発的,偶然な,偶,時折
비열한	見下げた(みさげた),情けない(なさけない)
초 심리학	超心理学
노천 채광	露天掘り
주의깊은	注意深い
아우성치다	叫ぶ
위독한	危ない,危険な,危険
윈도우	Windows,ウィンドウズ
플루타르크	プルタルコス
생략하다	1. りゃくす 2. 短縮する,縮む,略す,省略する
비유담	アレゴリー,寓言,ぐうげん
불쏘기개	てんか
독재정권	スターリニズム,独裁政治,幕府,bakufu,独裁
여하튼	やっぱり,tomokaku,とにかく,ともかく,兎も角,どうせ,何しろ
허풍떨다	過ぎる
튼다닥냉이	コショウソウ
오카피	オカピ
용감한 행위	武勇,技量
신용하는	堅い
비올족	1. ヴィオラ・ダ・ガンバ 2. ヴィオラ・ダ・ガンバ,ヴィオラ
케추아 말	ケチュア語
화성암	火成岩
화산학	火山学
식료품점	# 食料雑貨店,食料品店
소형 오토바이	単車,オートバイ
2개1조	二和音
탄화수소	炭化水素
화성인	火星人
올챙이	おたまじゃくし
화살촉	矢じり,慈姑
미끄러지는 사람	グライダー
우미한	典雅な
있는 그대로	勿論,もちろん,当然
후두개	喉頭蓋
증명하다	1. 言う,証明する 2. 証明する
예술적기교	武勇,技量
운전 면허	運転免許証,運転免許
주조 화폐	硬貨
본토박이	原住民,アボリジニ
호흡기계	呼吸器系
얼마 안 되는	たわいない
요사이	最近,さいきん,saikin
아양 부림	軟派
팔뚝시계	udedokei,腕時計,懐中時計
위안의 장소	避難所,オアシス
신수왕권	神権
중화작용	中和
비유의	回帰線,熱帯
우눈펜튬	ウンウンペンチウム
카이로	カイロ
필리핀의 수도	マニラ
독재정치	専制政治,独裁政治
정 식사	昼食
아코디언	手風琴,アコーディオン,アコーデオン
과라니 족	グアラニー語
벨파스트	ベルファスト
들으려 하지 않는	聾,聴覚障害者,耳の聞こえない,聾者
실질적으로는	1. 実際に 2. 実際に,殆ど,ほとんど
카라치	カラチ
-을 쓴것의 뜻	グラフ
취조의	実情調査
겁에 질린	パニック状態
무찌르기	爆撃
인쇄업자	印刷業者
적선지구	花柳
멜트다운	炉心溶融
자동판매기	自動販売機
아마 ...아니다	ぎりぎり
히브리인	ユダヤ人,ヘブライ語
히브리어	イディッシュ語
반복 악구	スローガン,標語
소금기가 있는	塩辛い,塩っぱい
옴스크	オムスク
요람사	乳幼児突然死症候群
교통마비	渋滞,雑踏,雑沓,交通渋滞
뚜렷이	思い切って
읍사무소	町役場,役場,公会堂
탕가니카	タンガニーカ湖,タンガニーカ
귀여워하는 아기	そば
노래하다	1. 歌う 2. 歌う
혈청학	血清学,serologie
쓸모없는 사람	無用
외면상	表面上
긴팔원숭이	テナガザル
재치있는 말	名言
화물열차	貨物列車
에스페란토란	エスペラント語,エスペラント
상류 계급	貴族制
포르노그래피	ポルノグラフィー,猥褻,ポルノ,エーブイ,猥本,アダルトビデオ
카랼라	カレリア
요하네스버그	ヨハネスブルグ
막대한 양	大洋,外海,海洋,海
치받이	上り坂
메  마음대로의	任意,不特定多数
활수함	寛大さ
확실히	必ず,確かに,きっと
황새치	1. メカジキ 2. メカジキ
출판사	発行人,出版社
인도네시아	インドネシア
비엔나	ウィーン
전차 차고	納屋,廐
확실한	確か,安全な
유럽연합/유럽聯合	EU,ヨーロッパ連合,欧州連合
광택없는	不透明な
출판업	出版,しゅっぱん
공립 도서관	公共図書館
칼로리	カロリー
뚱딴지	誘電体
놀랄만한	とてつもない,途轍もない
국제올림픽대회	オリンピック,近代オリンピック,オリンピック競技大会
놀랄만큼	凄く
영원히	幾久しく,eikyūni,ikuhisashiku,永久,永久に,永遠
칠면조	1. 七面鳥 2. 七面鳥 3. 家禽
헥타르	㌶,ヘクタール
홀어미	未亡人,後家
연직의	垂直の,直立,直立の,縦の,縦
코리올리의 힘	コリオリ力
비공식 서한	忘備録,メモ
발레리나	バレリーナ
채소 재배자	庭師
적색편이	赤方偏移
비알리	ビアリ
커뮤니케	コミュニケ
열대성 저기압	サイクロン
메인 주	メイン州
아버지로서	父方の,父性
외로운	1. ひとり 2. ひとり
친밀히	近く
보스니아	ボスニア・ヘルツェゴビナ,ボスニア,ボスニア・ヘルツェゴヴィナ,ユーゴスラヴィア,ユーゴスラビア
이스라엘	1. イスラエル 2. イスラエル
천체관측의	アストロラーベ
결정하다	思い切る
한없이 깊은	極端な
화요일	kayōbi,かようび,kayoubi,火曜日
우눈븀	ウンウンビウム
연주자	演奏家,演奏者,実行者
싫은 놈	うすのろ,でくのぼう
어울리지 않은	不調和な
카메룬	カメルーン
이라크 사람	イラク人
훈계하다	警告する,注意する,言い聞かせる
매우 싫은 느낌	吐き気
축합물	凝縮
영장류	霊長類
인문상의	文化的,文化の,文化的な
에덴 동산	極楽,パラダイス,楽園,十万億土,rakuen,らくえん,天堂
훈련생	実習生
옥수수	1. トウモロコシ 2. トウモロコシ
옥수수의 일종	ポップコーン
비올듯한	水っぽい
오슬로	オスロ
비위에 맞지 않는	憎い
오스뮴	オスミウム
옥수수홍반	ペラグラ
예언자	予言者
비슈누	ヴィシュヌ
대의 뜻의 결합사	百万
강한 혐오	憎しみ
여러가지로 해보다	畑鼠,ハタネズミ
뚱뚱한	肥満
야쿠트족	サハ語
확대하는 물건	アンプ,増幅器
러시아 연방	ロシア連邦,ロシア
호주의	オーストラリア
불모로하는 것	オートクレーブ
페로제도	フェロー諸島
인도북동부의왕국	ブータン
칼리지	大學,学園,大学,学寮,単科大学
부가 급부	ボーナス
피오르드	フィヨルド
기독교적 신앙	キリスト教
화염병	火炎瓶
외래의	esotica,エキゾチック
쓰르라미	セミ,蝉
연장한	長い,ながい,nagai
외래어	借用語
연장통	工具入,kōguire,こうぐいれ
중화민국	中華民国,中國,台湾
스목을 입히다	仕事着
남작 명부	かぞく
무력하게하다	無効にする,無力化する
영양물	食べ物,食料
농업 관련 사업	農業関連産業,農業,大規模農産業
칸막이	引き幕,とばり,緞帳
화씨의	華氏温度計,華氏
민주주의자	民主党支持者,民主主義者
生日	生日,生年月日,誕生日,誕辰
인간공학	人間工学,エルゴノミクス
조르는 사람	ロボット,ボット
남자다운	otokorashii,男らしい,おとこらしい
살집이 좋음	肥大,肥満
망가니즈	マンガン
연장자	化石
영양의	栄養素
비실재	否決
이슬람교	回教
초상연구	図像学
競馬	競馬
성호르몬	ステロイド
어휘론	語彙
상트페테르부르크	1. ペトログラード,サンクトペテルブルク,レニングラード,セントピーターズバーグ 2. サンクトペテルブルク
온전함	一切
긴 양말	ストッキング
에티켓	作法
또 한편	二度と,再び,又,二度,あらためて,再度,もう一度,って
네이멍구 자치구	内モンゴル,内蒙古
형태류	品詞
형태론	形態学,形態論
슬로베니아	スロヴェニア,スロベニア
중재재판하다	仲介する
해결짓다	解く
오존층	オゾン層
스라소니	ピューマ,山猫
精液	seieki,精液,せいえき,ザーメン
변두리 지역	近郊,郊外,地区
어리석게	只,単に
훌륭히	綺麗に
늪 같은	浸水した
훌륭한	1. 素晴らしい,subarashii,見事,素晴しい,立派な 2. 有名に
훌륭함	立派,壮麗
암하라어	アムハラ語
붙어 다님	妄想
싸움을 걸다	攻撃する
디즈니랜드	ディズニーランド
섭취하다	toru,同化吸収する
호찌민	ホーチミン市,サイゴン,ホーチミン
불리한 진술	害する,損なう
형편이 나쁜	ainiku no
피할수 없는	必然の,避けがたい
성교하다	ファックする,セックスする,はめ倒す,セックスをする,寝ると,エッチする,嵌める,性交する
있을 수없는	不可能
활자면	書体
호치키스	ホッチキス
입수 가능한	安い,手ごろな
쟁기질 하는 사람	農夫
불확실	疑い
북마리아나 제도	北マリアナ諸島,北マリアナ諸島連邦
싫어하면서	しぶしぶ,否々乍ら
다름슈타튬	ダルムスタチウム
어형론	形態学,形態論
맑게하다	照明する
오토만 제국	オスマン帝国
6.25	朝鮮戦争
종적을 감추다	逃げる,nigeru）,失踪する
그리스 문자	ギリシア文字
옹호하는 것	擁護,立証
독일 국가사회주의	ファシズム,ナチ主義,国家社会主義,ナチズム
어리석은	かたはらいたい,馬鹿らしい,kataharaitai,片腹痛い,馬鹿な
비산회	フライアッシュ
우량계	雨量計
세인트 엘모의 불	セントエルモの火
국부 서포터	jokkusutorappu,ジョックストラップ
족벌주의	ネポティズム
동형 이의어	同音異義語,同音語
온음정	全域
우라늄	ウラン
소비에트 연방	ソヴェト連邦,ソビエト連邦,ソ連,蘇連,ソビエト
그리스어 알파벳	ギリシア文字
화장실	1. 風呂場,バスルーム,浴室 2. 浴槽 3. お風呂 4. かわや,手洗い,べんじょ,厠,便所,休憩所,化粧室,憚り,トイレ
장미화단	ロザリオ
아프리카 흑인	黒人
마구잡이의	御座成の
회사원	実業家
문자 그대로의	文字通り,文字上の,逐語的な
후만증	傴僂
화이트 골드	白金
옛그리스은화	ドラクマ
환원제	還元剤
그 나무	グレープフルーツ
외용 물약	ローション,化粧水
빵모자	ニット,ニットキャップ
물레나물과의 과수	グアバ,グアヴァ
요리점	レストラン,食堂
요리장	料理,料理術,台所,割烹
권리침해	不当,不當
왕세자	皇太子,太子
요리법	1. 料理,料理術,台所,割烹 2. 調理,料理
흡수하다	飲む
웅대한	素晴らしい,subarashii,見事,素晴しい,立派な
긴 의자	ソファ
요리사	シェフ,コック,料理人,クック,調理師,りょうりにん
불의의 공격	サウスポー
치사한	見下げた(みさげた),情けない(なさけない)
에테르	1. ジエチルエーテル 2. ジエチルエーテル 3. ジエチルエーテル
수생 식물	水草,水生植物
몹시 조심하는	安全に
요기있는	ぶきみな
실룩샐룩	雁木,ジグザグ
고층 건축물	超高層ビル,摩天楼
요르단	1. ヨルダン 2. ヨルダン川,ヨルダン
비비다	拭く
알칼리성	アルカリ性
유행성 감기	流行性感冒,ryūkōseikanbō,りゅうこうせいかんぼう,infuruenza,インフルエンザ
로마 카톨릭교의	ラテン語
뜻하지 않은	igai na,いがいな,意外な,にわか
첼랴빈스크	チェリャビンスク
혼합하다	合同
에탄올	1. アルコール,エタノール 2. エタノール
시리우스	シリウス,天狼星
크리스마스 케이크	クリスマスケーキ
빈번히	絶え間なく,いつも
그 그림	はりつけ
인도적으로	人道的に
음자리표	音部記号
불화물 첨가법	フッ素化,フッ素添加
몹시 역겨운	ごますりの
커넥터	端子
샹들리에	シャンデリア
원형질막	細胞膜
꾸밈없이	ぎりぎり
수메르어	シュメール語,スメル人
수메르인	シュメール語,スメル人
텔아비브	テルアビブ,テルアヴィヴ・ヤフォ
소름끼침	鳥肌
삼투성의	多孔質
배고프다	お腹の空いていた,空腹な,飢えた
형태학	形態学,形態論
부활시키다	蘇らせる
마이크로폰	マイク,マイクロフォン
사악한 외설한	汚い
지붕이는 사람	ワラジムシ
때 늦은 지혜	後知恵
숭배하다	よせる
부활절	1. イースター,復活祭,聖大パスハ 2. 過越
전체 회교국	回教
우두종	疫苗,痘苗,ワクチン
요란한	うざい,騒がしい,姦しい
공중 질소고정	窒素固定
북아메리카	北米,北アメリカ
혈기왕성하여	生きている
왁자지껄	喧々囂々,騒ぎ,騒音,騒動,猥雑
세상이 싫어져서	疲れた
테러행위	アナキズム,無政府主義
카테고리	部門,家族
예정표	計画,議事,日程
입을 수 있는	疲れる
형태소	形態素
불필요하게	1. 不用に 2. 不用に
아일랜드	1. アイルランド 2. アイルランド,Airurando
신뢰하다	頼る,あてにする
그 깍지	莢豌豆
타지마할	タージ・マハル
뜻하지 않게	ふと,無意識的に
헤로데	ヘロデ
흥분하기 쉬운	可燃性の
여송연	たばこ,シガー,葉巻
룬 문자	ルーン文字
적색 거성	赤色巨星
독일사람	ドイツ人,独語,ドイツ語,ドイツ
해쓱한	青ざめた
정월초하루	元日,元旦,新年,gantan,ganjitsu,がんじつ,がんたん
다마스쿠스	ダマスカス
면역조치	予防接種
신을 닦음	靴磨き
생물학응용의	生物学
연소성	可燃性
올림픽	オリンピック,近代オリンピック,オリンピック競技大会
피막 조직	上皮
명성을 얻은	幸運な,成功した,成功裏の
정십이면체	正十二面体
실리콘 밸리	シリコンバレー
에어백	エアバッグ
핵연료	核燃料
오믈렛	オムレツ
크리스마스 카드	クリスマス・カード
허무한	短命な,はかない,束の間の
幸福	幸い,幸せ
구워삶다	誑す,丸め込む,強請る
헤로인	ヘロイン
토탄 같은	泥炭
작은창자	小腸,しょうちょう
소스라침	驚き
크리스마스 캐롤	shōka
염세관	悲観主義
영사관	領事館,りょうじかん,ryōjikan
잠에서 깸	kakusei
양치질 약	洗口液
좀소리가 높은	大声
모권사회	家母長制
에어러솔	煙霧質,エアロゾル
침팬지	黒猩々,チンパンジー
해왕성	ネプチューン,ネプトゥヌス,海王星
갑자기 생기는 것	菌類,きのこ
억지로	強制的に
라비올리	ラビオリ
산화중수소	じゅうすい,重水
어쨌든	やっぱり,tomokaku,とにかく,ともかく,兎も角,どうせ,何しろ
염색체	染色体
어쩌다	ふと,無意識的に
여시장	市長
양치류	シダ植物,しだ,シダ,羊歯
요금표	関税
약탈물	戦利品,略奪品
치열 교정	歯科矯正学
열을 내다	気温,おんど,温度,ondo,熱
창 강	揚子江,長江
어쩌면	万一,ひょっと,tabun,多分,若しや,まんいち
돈 쓰는 사람	使い手,浪費家,ろうひか,つかいて
카타르	1. カタール 2. カタール
우간다	ウガンダ
물방울이 듣다	しくしく泣く,すすり泣く,泣く
우스운것	諺,ことわざ,格言
다마스쿠프	ダマスカス
조각하다	切る
합성대사	同化
침투성	透過性
화강암	花崗岩
항저우	杭州
용광로	1. 高炉 2. kama,炉,karo,火炉,かろ
수완을 요하는	快い
헤르츠	ヘルツ
일부 다처제	多婚性
오리건	オレゴン州,オレゴン
일소하다	大掃除する
구혼하다	求愛,求愛する
꿰매어 붙이다	1. 縫う 2. 縫う
지금까지는	これまでのところ,これまで,今まで
친화력	食欲
어울림	特徴,適当
언어학	言語学,語学
떨어지다	切り離す,切断,切断する
언월도	シミター,偃月刀
움라우트의 부호	分音符号
어의론	セマンティック
불성실한 언행	不誠実
수영 잘하는 여자	人魚,ningyo,にんぎょ
자유형식	自由形態素
캘커타	コルカタ,カルカッタ
카페인	カフェイン
뿐만 아니라	その上,しかも,その上に,尚且つ,さらに,katsu
콜레스테롤	コレステロール
은행 계정	銀行口座
인터내셔널	インターナショナル
핵융합	核融合
빅토리아	ビクトリア
억제하다	1. 拘束する 2. おさえる
백과사전	大事典,百科全書,事典,百科事典
콘서티나	アコーディオン式,コンサーティーナ
활공기	グライダー
콜럼븀	ニオブ
계산 착오	いさん,isan,違算
기니 공화국	ギニア
의붓형제	たねちがい,胤違い,異父母兄弟
오리온	オリオン座
즉석 반주자	妖婦,妖女,ファム・ファタル
싫어하다	嫌う,憎む,いやである
피콜로	ピッコロ
물려받다	継承する,受継ぐ
올레핀	アルケン
콜레라	コレラ
밉살스러운	憎い
유디오미터	ユーディオメーター
콜라주	コラージュ
射精	しゃせい,感動詞,感嘆詞,間投詞
노보시비르스크	ノヴォシビルスク
오리사	オリッサ州,オリッサ
강한 충동	仕事,職業,天職
수영 풀	プール
형제 자매의 손자	大甥
만큼 반복하여	二度と,再び,又,二度,あらためて,再度,もう一度,って
억울함	汚辱,屈辱
어원학	ごげん,gogen,語源
매장물조사관	検死官
언젠가	いつか
하찮은	たわいない
스페인 사람	スペイン人
자웅 동체의	雌雄同体の,雌雄同体,半陰陽,半陰陽の
불쾌한 음조	不協和音
양면 가치의	どっちつかず
한창때	夏時,なつ,natsu,夏期,夏,夏時間
항주학	宇宙航行学
아피아	アピア
카토비체	カトヴィツェ
브라티슬라바	ブラチスラヴァ,ブラチスラバ
무릎꿇다	跪く
여성의	女性的な
백열전구	電球
서머 타임	夏時,なつ,natsu,夏期,夏,夏時間
올리브	1. オリーブ 2. オリーブ
암페어	アンペア
악한의	巧妙な,狡い,ずるい,狡猾,悪賢い
언제나	1. 絶え間なく,いつも 2. やっと,ついに,結局,最終的に,とうとう
다이너마이트	ダイナマイト
콘테이너	いれもの,iremono,入物,入れ物,コンテナ,容器
오만한	傲慢な,横柄な,高慢な
행운의	運のよい,幸運,運の良い,ラッキー
포클랜드제도	フォークランド諸島
새너제이	サンノゼ
하청인	サブコン
해질녘	黄昏,薄明,日暮
시끄러운	賑やかな
코린트	コリント,コリントス
골다공증	骨粗鬆症
식탁용 소금	食塩,塩
예술품	武勇,技量
여왕벌	女王バチ
코모로	コモロ
카프탄	カフタン
양탄자	カーペット,絨毯
텔레비젼	受像機,テレビ,テレビセット
텔레비전	1. テレビ 2. 受像機,テレビ,テレビセット
석유따위	鉱物油,鉱油
황갈색	シエナ土,シエナ色
컴퓨터 게임	コンピューターゲーム,ビデオゲーム,テレビゲーム
올빼미	ふくろう,梟,フクロウ
유행병학	疫学
페르샤어	ペルシア語
시나고그	仮庵,幕屋,シナゴーグ
카톨릭교	カトリシズム
파이커 활자	エム
교구 목사	牧師
뜨내기 노동자	ベビーブーマー
연예장	競馬場
클라리넷	1. クラリネット 2. クラリネット
수입업자	ゆにゅうぎょうしゃ,輸入業者,yunyūgyōsha
학자연 하는	衒学者
줄 수 있는	安い,手ごろな
오사까	大阪市,大阪
일치하지 않는	憎い
엉터리수단	ナラタケ
유제품 판매소	酪農場,牛乳屋,牛乳販売店,日用雑貨店,牧場
집게벌레	挟み虫,ハサミムシ
실망거리	乱雑
유혹하는 여자	妖婦,妖女,ファム・ファタル
憂鬱	憂鬱
캘리포니아	カリフォルニア州,加州
탄산가스 넣기	曝気,給気
헤즈볼라	ヒズボラ
언청이	としん
所聞	うわさ,噂
예비조사	偵察
행정의	政治上の,政治的な
불법입국자	違法な,ならない
연장 전기줄	延長ケーブル
콜롬보	コロンボ
대립유전자	対立遺伝子,アレル
컴퓨터 과학	情報学,情報科学,コンピュータサイエンス
표제 없는 단평	段落
쉽사리 믿지 않음	かいぎ
排球	排球,バレーボール
뺑소니 치다	逃げる,nigeru）,失踪する
비공식 회담	話し,カンバセーション,談話,かいわ,会話,話,対話
매듭 있는	不可解な
오사카	大阪市,大阪
비결정의	アモルファス
예정대로	計画,議事,日程
마법을걸다	化かす
붙임성 있는	愛想のいい
주의 깊은	注意深い
불시에 쳐서	驚かせる
우화적으로	凄く
남자 수영 선수	人魚,ningyo,にんぎょ
세인트 키츠 네비스	セントキッツ・ネイビス,セントクリストファー・ネイビス
자격 증명서	認証
주요도시	to,しゅふ,町,shufu,都市,首府,主要都市,京
열역학	熱力学
아메리카 라이온	ピューマ
도널드 덕	ドナルドダック
호두색	クルミ,シナノグルミ,くるみ
새끼손가락	こゆび,小指
러시아어	1. ロシヤ語,露西亜語 2. ロシア語
모래언덕	砂丘
shigeumchi	法蓮草,ホウレンソウ,ほうれん草
미토콘드리아	ミトコンドリア
열심인	熱心な
마그네슘	マグネシウム
유핵세포	真核生物
영속물	えいせい,常,永世
비프스테이크	ステーキ
意味	意義,心,意味
콜드크림	コールドクリーム
이기적으로	かってに,katte ni,勝手に
의도하지 않은	偶然の
意外	1. igai na,いがいな,意外な 2. igai na,いがいな,意外な,にわか
오보에	オーボエ
현명한	明敏
완전론자	完全主義者
타협적인	親切な
해결하다	思い切る
불결한 상태	スライム,ぬめり
탄소 사이클	炭素循環
무한궤도	皮虫,毛虫,ワーム,芋虫,キャタピラ,無限軌道
전속 의사	検死官
마늘이 있는	辛辣です
必要	nyūyō,ひつよう,入用,にゅうよう
작은파도	波紋,ウェーブレット
전염성간염	A型肝炎
시력 측정 의사	眼科医
파라핀족	アルカン,パラフィン
에스컬레이터	エスカレーター
에이커	エーカー
에이콘	ドングリ,団栗,どんぐり,donguri
요나단	紅玉
여성 단체	姉妹
채무초과	支払不能
코발트	コバルト
파괴의 자취	ゴミ
홀로그래피	ホログラフィー
아스파라거스	アスパラガス
부자유스런	1. 不便な 2. 不便な
북유럽 고대 문자	ルーン文字
현무암	玄武岩
심히 흥분한	必死な
와상성운	渦巻銀河
로자리오	ロザリオ
한 술	スプーン,さじ
예술가	アーティスト,画家,芸術家,作家
젊음에 넘치는	若々しい
북부 아메리카	北米,北アメリカ
표현의 자유	表現の自由,言論の自由
확대경	虫眼鏡,拡大鏡
예술의	芸術的な
무익한 짓	muda,むだ,無用,無駄
능력 있는	1. できる 2. できる
혈관 압축기	圧縮
뉘노르스크	ニーノシュク
수의적인	志願して
하이 테크놀로지	ハイテク
한 폭	幅,巾
씹어 삭힘	咀嚼
괴롭히다	1. じらす 2. じらす 3. 気をそらす 4. 騒がす,いらいらさせる,苦しめる,煩わす 5. 圧迫
캄보디아 리엘	リエル
남녀 양성 구유자	双成り
환상 열석	支石墓
밀크 초콜릿	ミルクチョコレート
어느땐가	どこかに
빈혈증	貧血
마이크로미터	マイクロメートル
야자수	1. ココナッツ 2. 椰子
이야기 하다	物語る,教える
사우바도르	サルヴァドール,エルサルバドル
카지노	賭場
오토바이 경주장	高速道路
대단한 행위	尻,ケツ
클라이언트	1. クライアント,顧客,きゃく,客 2. 顧客
회광기	ニオイムラサキ,ヘリオトロープ,薄紫,キダチルリソウ
깽깽 짖다	きゃんきゃんほえる,悲鳴をあげる,ぺちゃくちゃしゃべる
비현실	現実離れ
홍등가	花柳
암청색	コバルト
더 앞으로	前へ
엽록소	葉緑素,クロロフィル
양아욱	ゼラニウム
양치는 사람	羊飼い
알아채다	見る
온도계	温度計
회계사	会計士
여편네 손에 쥐인	鼻下長,二本棒,女房天下
변동하는	ビクビク
불합리하게	無暗に
연료유	灯油
꾀 까다로운	格好悪い,見苦しい,醜い,不味い
해초회	昆布
아폴로우주선	アポロ,アポロン
書店	本屋,書店,ほんや,hon'ya
오도하는	欺瞞的な
비행술	航空
오리너구리	カモノハシ
측은히 여김	慈悲
케레스	ケレス,ケレース
밀리 리터	立方センチメートル,立方センチ,ミリリットル
비행선	ツェッペリン,軽気球,飛行船
치찰음	歯音,歯擦音
커피 나무	珈琲
비행장	1. 飛行場 2. kūkō,空港,くうこう
여름철	夏時,なつ,natsu,夏期,夏,夏時間
피하다	予防,防ぐ
석탄건류	炭化
카자흐	カザフスタン
재미있는	おもしろい,面白い,omoshiroi
대요 요목	教科
공기와 혼합시키다	蒸発する
칠판 지우개	消しゴム
쿠닐링구스	クンニリングス,クンニ,愛舐め
비행기	航空機,飛行機
메가 헤르츠	メガヘルツ
예레반	エレバン
습관성의	常習的,中毒性
짙은 남색의	kon
비하르	ビハール州,ビハール
호랑이	1. トラ,ヒョウ,虎 2. トラ,虎
캡스턴	manriki,万力,まんりき
회귀선	熱帯地方
등대지기	灯台守
코기견	コーギー
니카라과	ニカラグア
약제사	薬剤師
파생언어	方言,ほうげん,訛り
차례로풀이하다	明示する,説明する
압축기	圧縮
알카에다	アルカーイダ
버릇 없는	失礼な
가르치기	授業
카자크	コサック
로마신화의 아레스	アレス
알칼리	塩基
거리측정기	マイクロメートル
회귀년	太陽年
양어지	養魚鉢,水族館
웨일즈 사람	ウェールズ語
크레믈린	クレムリ
흥분의 절정	ōgazumu,オルガスム,オーガズム,オルガスムス
미래 시제	未来,未来時制,未来形
연락선	フェリー
어린아이 같은	幼稚
가는 기롭	ブラ,ブラジャー
가마우지	う,鵜,ウ
호로파	フェヌグリーク
환락에 지친	うんざり
위상수학	位相幾何学
대조 역사 연표	共時性
실용주의	功利主義,実利主義
改寤	改寤
가는 기구	とぎ器
쓸데없이 참견하는	実利的な,実用主義の
완고한	頑固な
생각다 못해	緊急に
남아프리카 공화국	南部アフリカ,南アフリカ
이기적이아닌	1. 利他的 2. 利他的
접수원.응접원	受付係,秘書
여러분	サー,だんな
파킨슨씨 병	パーキンソン症候群,パーキンソン病
모래상자	砂場,サンドボックス
고립 주의	孤立主義
유별하다	分類する
벵골비단	ベンガル
안초비	片口鰯,アンチョビ
바퀴멈추개	スリッパ
캐나다 기러기	カナダガン
좁은 골짜기	峡谷
비늘등이 없는	裸の,裸
...에 저항하다	耐える,反抗する,撃退する,抵抗する
왜가리	1. 白鷺,鷺,サギ 2. 鷺
日本	日本
명백히 말한	明晰な
이야기하다	物語る,教える
컴퓨터화	コンピュータか,コンピュータ化
남자14~25세	青年期,青春
오늘밤	今晩,今夜
지방의 중심지	町,都市,街,村
비틀즈	ザ・ビートルズ,ビートルズ
콧구멍	鼻孔
반항 행위	破壊活動
전자 우편	メール,Eメール,電子メール,イーメール
황도대	黄道帯
호르몬	ホルモン
호리는	欺瞞的な
호리다	化かす
모래시계	1. 砂時計 2. 砂時計
아첨의	甘い
콩고강	コンゴ共和国
오늘날	本日
海王星	ネプチューン,ネプトゥヌス,海王星
수륙 양용	水陸両用
하프늄	ハフニウム
야영지	キャンプ場,野営地,テント場
부에노스 아이레스	ブエノスアイレス
헤시피	レシフェ
남자 같은	1. otokorashii,男らしい,おとこらしい 2. 男性 3. 男性
긴장하고 있는	ビクビク
온두라스	ホンジュラス
성령의 은사	教祖的指導力
외국선	異人,外人,外国人,がいこくじん
약제학사	薬剤師
어업권	漁業,水産
대담한 행위	大膽,大胆
혈색소	ヘモグロビン,血液色素,血色素
에스겔	エゼキエル書
외국인	1. 外人,外国人 2. 異人,外人,外国人,がいこくじん
전당포 주인	質屋
외기권	外気圏
영향력있는	重要
그레이트배리어리프	グレート・バリア・リーフ
서양호도나무	シナノグルミ
어조가 좋음	音楽
해고하다	打ち首にする
마크업 언어	マークアップ言語
긴 행렬	鰐,わに,wani,ワニ
환경 과학	生態学
악티늄	akuchiniumu,アクチニウム
핫팬츠	ホットパンツ
뽕나무	1. 桑 2. クワ
합성사진	コラージュ
지나치게 자다	寝過ごす,寝坊する,寝坊
아우슈비츠	アウシュビッツ,オシフィエンチム,アウシュヴィッツ
외견의	表面上
감청색의	群青色
사이가산양	サイガ
러시아 서부지방	ベロルシア,ベラルーシ
열병의	熱の（ある）
등화실	灯籠,ランタン,提灯
크로이츠펠트야콥병	Kuroitsuferuto-Yakobu-byō,くろいつふぇると・やこぶびょう,クロイツフェルト・ヤコブ病
소말리아	ソマリア
최연장자	パパ,父親,お父さん,父上,父,親父
오락관	賭場
외교관	外交官
홀리다	ぶきみな
뽐내어	無益
여분의	過剰な
Melbourne	メルボルン
과두 정치	寡頭制
슬기로운	明敏
오로지	marude,全く,まるで,全て,丸で
광범위에 걸친	広汎
윈체스터총	ウィンチェスター
텔루구어	1. テルグ語 2. テルグ語話者,テルグ語
폭력주의자	テロリスト
크렌베리	クランベリー
탓으로 하다	任命する
구별할 수 없는	同一の,一卵性の
거친 돌	ゴミ
비하르 주	ビハール州,ビハール
생략부호	……,省略記号,…
적지않게	中々,実質的に,なかなか
어용론	語用論
예배소	仮庵,幕屋,シナゴーグ
열분해	熱分解
아파치	アパッチ族
많이 먹는	貪欲,飽くなき,貪欲な
씹하다	ファックする,セックスする,はめ倒す,セックスをする,寝ると,エッチする,嵌める,性交する
오록스	オーロックス
에스프레소 커피점	エスプレッソ
아파트	アパート
물을 통하지 않은	水を通さない
아폴로	アポロ,アポロン
안티몬	アンチモン,アンチモニー
계산할수 있는	可算
비밀 결사단	秘密結社
에스라	エズラ記
온라인	オンライン
예절바름	hitogara,ひとがら,人柄
초자연적인	不気味な
바르샤바	ワルシャワ
비타민	ビタミン
앵초색	桜草
대규모 공동묘지	墓地
사이프러스	キプロス
엿보기	覗く
비키니	ビキニ
현세의	最近,新しい
경쟁상대	挑戦者
자동 교통신호기	じんぞうにんげん,人造人間
엿보다	覗く
청동기 시대	青銅器時代
공산주의	1. 共産主義 2. 共産主義
항해의	航海
불쾌한 물건	迷惑,厄介者
글루타민산소다	グルタミン酸ナトリウム
압도하다	壊滅させる,鎮圧する
생물의 다양성	生物多様性
아테네	アテネ
형사학	犯罪学
으뜸패의 일종	マタドール
아테나	アテーナー
柔道	jūdō,柔道
여배우	女優,俳優
앙카라	アンカラ
연미복	燕尾服
바람난 처녀	妖婦,妖女,ファム・ファタル
여보게	親友,友,shin'yū,しんゆう
슬퍼보이는	悲しい,悲惨な
돼지고기	豚肉,ポーク
자양이 되는	栄養素
노란설탕	黒砂糖
회색의 큰 이리	大陸狼
헤이그	ハーグ
축 늘어진	故障
달성하다	達成する,収める,成し遂げる
영국남해안의 주	ハンプシャー州
연무질	煙霧質,エアロゾル
열쇠구멍	鍵穴
핫케이크	パンケーキ
혹보기	斜視
자동 온수 장치	間欠泉
바보얼간이	井守,イモリ
법률준수	合法,合法性
콘도르	チリ
위태로운	ブラブラした
찰흙을 칠하다	スライム,ぬめり
비슬비슬하는	ブラブラした
알코올성의	アルコール入りの
어스름	黄昏,薄明,日暮
양자 역학	量子力学
제빙장치	解氷剤,溶氷剤
자두의 일종	オルレアン
固有名詞	名前,固有名詞
양자화	量子
말레이시아	マレーシア,Marēshia
라디오의	無線,ワイヤレス
양전자	陽電子
번영하다	1. 栄える 2. 咲く
별것이 아닌	平凡
광장 공포증	広場恐怖症
버리게 하다	やめさせる,乳離れさせる
생물학상의	生物学
프랑스 빵	フランスパン
청산칼리	シアン化カリウム
페르미온	フェルミ粒子
말괄량이	おてんば
사보타주	破壊活動
똑똑히	1. 声を出して,大声で 2. 声を出して
실용주의의	実利的な,実用主義の
마상시합	トーナメント
영리한	明敏
어려운 문제	謎,nazo
토바고섬	トバゴ島
자동차 운전자	運転手
손끝으로 다루는	操作的
부분적으로	一部,部分的に
대학밖의 세계	実際の生活,実生活,実社会
양이온	カチオン,陽イオン
사이비신자	宗教
파벌	派閥
제1원리	いろは
힐ㄴ	反対尋問
능가하다	越える,超える
음의 조화	交響楽団,交響曲
팔목	リスト,手首
파면	堕落,daraku,だらく
패럿	ファラッド
판매	1. 販売 2. 販売
슐롱스크	シレジア
추상론	形而上学
투표	投票
팔뚝	前膊,前腕
키프로스	1. キプロス 2. キプロス
특사	恩赦,許し
특성	個人主義
팬더	パンター,ヒョウ
불가피한	必然の,避けがたい
무슬림	イスラム教の
포르토프랭스	ポルトープランス
팔다	1. 売る 2. 売る 3. 売る
파동	波動
암자색	なす,茄子,nasubi,nasu,ナス,なすび
판다	パンダ
여자 대사	大使
패기	野心,抱負,アンビション
패권	ヘゲモニー,覇権
충분한	十分な
무신론	無神論
몽타주	コラージュ
트림	げっぷ,噫気する,げっぷする,うっぷ,うっぷする,おくび,噫気,おくびする
불가해한	説明できない
튜바	スーザフォン,チューバ
도도한	うるさい
가스처형실	ガス室
트럭	1. トラック 2. トラック
통할	大統領就任期間,大統領職,社長職,社長在任期間
티끌	原子,ほこり,粒子
통화	1. 通貨,硬貨,貨幣 2. 通貨 3. 通貨,硬貨,お金
투쟁	争い
튤립	チューリップ,chūrippu
계산하는	計算高い,keisandakai,けいさんだかい,計算可能な
통풍	痛風
알제리	アルジェリア
퇴직	ていねんたいしょく
송로 무리의 버섯	セイヨウショウロ
투시	透視
악마적 행위	サタニズム
토픽	話題,主題
명시하는	表面上
아줌마	おば,小母さん,おばさん
여드름	1. 丘疹,面皰 2. 座瘡,にきび
퇴역	ていねんたいしょく
토쿄	帝都,とうきょう,Azabu,東京
특권	占有権,特権
진전 마비	パーキンソン症候群,パーキンソン病
토탄	泥炭
제어하기어려운	賑やかな
명확히	必ず,確かに,きっと
카탈로니아	カタルーニャ,カタロニア
통지	助言
명예의 낱말	名誉の単語
통일	再会
통장	通帳
연두빛	黄緑色
에스토니아어	エストニア語
툴륨	ツリウム
투명	透明性
톈진	天津,天津市
표준 편차	標準偏差
퇴보	墮落
토인	原住民,アボリジニ
퇴미	墮落
물시계	水時計
다카르	ダカール
텐트	パビリオン
토장	葬式
의견을 달리하다	異なる,揉める,反対する
여동생	妹,imouto
토시	ブレスレット
양치기 개	bokuyōken,ぼくようけん,牧羊犬
톤수	トン数
통상	一応,主に,大概
터키	トルコ共和国,トルコ,土耳古
저혈압증	低血圧
톤세	トン数
까마종이	網笠茸,アミガサダケ
미국 북동부의 주	バーモント
톱밥	おがくず
토성	サトゥルヌス,サートゥルヌス,土星
뢴트겐 진찰	放射線医学
탄핵	弾劾
털의	1. 毛深い 2. 毛深い
탐폰	タンポン
문시인	所長,看守
템스	テムズ,テムズ川
캐처보트	キャッチャー,捕手
열대의	回帰線,熱帯
탑파	仏舎利塔,ストゥーパ,卒塔婆
불가항력	ジャガーノート
탱커	タンクローリー,油槽船,オイルタンカー,タンカー
무심한	さりげない
태풍	台風,颱風
탐험	研究
탄탈	タンタル
털실	毛糸,ウール
충분히	1. 優 2. 優 3. 順調に
얼마간	一部,部分的に
토론	論争
토륨	トリウム
지그재그로	雁木,ジグザグ
롬바르드족의 사람	ロンバルド語
이인종 간의	交じった,混合した
키토	キト
탯줄	臍の緒,臍帯
몸통옷	胴回り,ウエスト,胴のくびれ,腰
삼단 같은 머리	hen
중력 양자	重力子
천칭자리	てんびん座,天秤座
목판화	木版画
태아	胎児,胎兒
태양	アポロ,アポロン
탈저	壊死
애쓰다	闘う,努力,努める
통계	統計学,統計
통가	トンガ
독단론	教義
터번	1. ターバン 2. ターバン
당직 아닌 선원	怠け者
터븀	テルビウム
어처구니 없이	無理に
토끼	1. 野兎,ノウサギ 2. 兎 3. 兎
테마	補題
터부	1. タブー 2. タブー
태자	おうじ,ōji,王子
터빈	タービン
비틀거리다	よちよち歩く,よたよた歩く
되는 대로의	ランダムな,任意の,勝手気まま,勝手気ままな,不可解,無作為な,出任せ,出任せの
타액	唾液,唾,tsuba,つば,だえき,daeki
연식 야구	ソフトボール
택시	タクシー
아이티	1. ハイチ 2. ハイチ,イスパニョーラ島
탄알	弾丸
연대장	大佐
타이	タイ,サイアム,taikoku,タイ国,泰国,たいこく
토가	トーガ
타원	楕円
타월	タオル
탈장	ヘルニア,脱腸
탐욕	1. 強欲 2. 強欲
타조	ダチョウ
토고	トーゴ
최전선	前線
큐핏	キューピッド
하녀	女中,メイド
학년	太陽年
한낮	正午,jūni-ji,昼,真昼,しょうご,shōgo,十二時,じゅうにじ
품질	長所,特徴,属性
합금	1. 合金,金属 2. 合金
피다	咲く
영대 재산	永世
심계항진	頻脈
합동	総合
초감각적감지	透視
춘분점	春分点
학동	しょうがくせい,生徒
할당	分配,割り当て
퓨셔	赤紫色,ホクシャ,フクシャ
풍차	風車
우주여행	宇宙旅行
한담	話々,世間話
하늘	上顎,口蓋
하늄	ドブニウム
포함	砲艦
폭한	バーサーカー,ベルセルク
피고	被告
풍수	風水
풍습	伝統,でんとう
폭풍	1. ハリケーン,大暴風 2. 嵐
표음	音韻,音素
포포	ポーポー
양털기름	卵黄,らんおう,黄身
방심 않는	目が覚めて
표어	スローガン,標語
한계	1. 国境 2. 国境,エッジ
프랑	フラン
품위	hitogara,ひとがら,人柄
한국	韓國,韓国,大韓民国
영속적으로	いつも
하계	夏時,なつ,natsu,夏期,夏,夏時間
퓨마	ピューマ
밀가루	小麦粉,粉
민간의	市民の
표준	規範
미가엘	ミカエル,マイケル
리보핵산	リボ核酸
백조자리	はくちょう座
죄가 있는 듯한	有罪い
운수 좋은	運のよい,幸運,運の良い,ラッキー
댄스 홀	舞踏場
도리 받이	雛形
표시	意義,心,意味
폐해	潰瘍
평화	平和
자귀짚다	パグ
옛날에	旧来,かつて
치즈케이크	チーズケーキ
평판	名声,評判
양성의	1. 両性具有 2. 雌雄同体の,雌雄同体,半陰陽,半陰陽の 3. 両性具有
양성자	陽子
풍미	軽食,間食,スナック
깊이 베어든	根深い,nebukai,ねぶかい
초콜렛	ココア
풀다	解く
푸들	プードル
편지	手紙
미개인	異邦人,不信者
염색하는 사람	ダイヤ
호찌민 시	ホーチミン市,サイゴン,ホーチミン
소년단의 반	警備
펌프	1. ポンプ 2. ポンプ
표범	1. パンサー,ジャガー,ヒョウ,ピューマ,豹 2. ヒョウ 3. トラ,ヒョウ,虎 4. パンター,ヒョウ
폭우	大雨,土砂降り
포위	包囲,攻城戦
폭정	スターリニズム,独裁政治,幕府,bakufu,独裁
포배	胞胚
접촉 반응	触媒作用
표기	文字綴り,スペル,綴り,正字法
부끄러워하여	恥じている,恥ずかしい
다중언어	多言語
극성스러운	大声
에르븀	エルビウム
포목	引き幕,とばり,緞帳
표고	鋤焼き,シイタケ,椎茸
평가를 잘못하다	誤算する
포부	野心,大望
압제자	圧制者
대양주의	オセアニア,大洋州
생존하다	ある,いる
엘레지	哀歌
농가 공제 조합원	農家
양서류	両生類,りょうせいるい
애욕의	嫌らしい,エッチ
평온	安穏,安寧,あんねい
폐암	はいがん,肺癌,haigan
평양	平壌,ピョンヤン,平壤
풍금	ハーディ・ガーディ
폭소	強風
평영	平泳ぎ
열등생	うすのろ,でくのぼう
평안	死者のためのミサ,鎮魂歌
포도	葡萄,ブドウ
이집트의 은자	アンソニー
대중성	人望,にんき,じんぼう,ninki,jinbō
펄사	パルサー
폭동	反乱,ほうき,hōki,暴動
특히	1. 特別,一入,ひとしお,別段,特殊に,特別に 2. 特別,特殊に,特別に
목화씨	綿実
포대	城塞
파타	ファタハ
니코틴	nikochīn,ニコチン
양성애	両性愛
팝콘	ポップコーン
바누아투	ヴァヌアツ,バヌアツ
펄서	パルサー
퍼스	パース
컴플라이언스	順守
폐렴	肺炎
편물	編み物
양서의	水陸両用
자기본위	自惚,己惚
팬츠	ズボン,パンツ
악어의 눈물	嘘泣き
도뇨관	カテーテル
운두가 앝은 덧신	サンダル,草鞋
크레디트 카드	クレジットカード
평범	決まり文句
포로	とりこ,hitoshichi,人質,ひとしち
페스	フェズ
폭로	1. 暴露 2. 暴露 3. 暴露 4. 暴露
파편	ゴミ
사정 하다	批評する
펜싱	フェンシング
에르그	エルグ
팩스	ファクシミリ,ファックス
덴마크사람	デンマーク語
빈틈 없는	あやうい,危うい,ayaui,あぶない,abunai
박해 하다	圧迫
덴마크	デンマーク,丁抹
큰 화재	火災,大火,火,大火災
동급생	クラスメート,級友,同級生,クラスメイト
대정의	垂直の,直立,直立の,縦の,縦
아니스 술	アニス
평년	平年
폭격	爆撃
팔월	葉月,8月,八月,はちがつ
양성교	両性愛
파이	ピザパイ,パイ,ケーキ
대주교	大主教
편도	アーモンド
광선 공포증	光線恐怖症
파지	もち,保持
페루	ペルー
페름	ペルミ
장남감 곰	テディベア
티크	チーク
팔찌	1. ブレスレット 2. ブレスレット 3. ブレスレット 4. ブレスレット
팽이	独楽
티탄	チタン,チタニウム
번거로운	冗長な
앞으로	前へ
특질	専門
큰 모랫바람	sunaarashi,砂嵐,すなあらし
경솔하게	きゅうきょ
파샤	州知事
파산	支払不能
펭귄	ペンギン
파섹	パーセク
편견	せんにゅう,偏見,sen'nyū,先入,先入観,僻見
평가	1. 品定め 2. 鑑定
모험심	きぎょう,企業,kigyō
치열	いれば,入歯,ireba,総義歯
치약	1. 練り歯磨き,歯磨剤 2. 歯磨,歯磨剤,歯磨, 歯磨き,歯磨き粉
지적재산	知財,知的財産
친왕	おうじ,ōji,王子
칼슘	カルシウム
치욕	1. 羞恥心 2. 羞恥心
등록되지 않은	生の
도량형	測定学,度量衡,計測学,計量学
침술	鍼治,鍼,鍼治療,鍼術,漢方
방송앵커맨	アンカーマン
추방자	hinin,ひにん
초출력	スーパーパワー
케냐	けにあ,ケニア
침식	侵食,腐食,しんしょく,shinshoku
침실	ベッドルーム,寝室
르포르타주	記事,ルポルタージュ
인력 유효 총인원	人力,じんざい,人々,人材
측지	測地線
아열대	亜熱帯
드루즈파	ドゥルーズ派
출혈	外出血,出血
카불	カブール,カーブル
데시벨	デシベル
칼집	さや,鞘
콩고	コンゴ共和国 (ブラザビル),コンゴ共和国,コンゴ川
칭찬	賛美,万丈
조정하다	なだめる
실증주의	実証主義,実証哲学,実証論
영구히	1. 幾久しく,eikyūni,ikuhisashiku,永久,永久に,永遠 2. 無限に
의 실금	失禁
붉은 색 염료	グレナデン・シロップ
아마로 만든	亜麻
직사각형	長方形,ちょうほうけい
친척	いとこ,従兄弟,従姉妹
커민	クミン
캐슈	カシュー,カシューナッツ
치즈	チーズ
캐시	現金,硬貨
치질	疣痔
침전	沈積,沈降,堆積作用
돌리고 남은 패	未亡人,後家
스텝지대	ステップ
징계하다	ばっする
카잔	カザン
무엄한	mottainai,もったいない
칠월	shichigatsu,七月,文月,7月,しちがつ
흑색종	メラノーマ
카약	カヤック
친족	血族
무용극	バレエ
췌장	膵臓
추측	推測
몹시 싫은	憎い
흑사병	ペスト
침대	ベッド
추첨	投票用紙
침니	シルト,沈泥
예법에 어긋남	文法違反
애수감	痛切
충정	こんせつ,konsetsu,懇切
오쟁이진	コキュ,コキュー
침낭	寝袋
안쓰는	時代遅れ,廃れた,退化した
문예 한담	話々,世間話
추진	推力
동등한	相当
축적	未処理の仕事
축전	結婚記念日,誕生日,記念日
추인	ひじゅん,批准,hijun
우라니아	金星,ウェヌス
법칙의 무시	油断,過失,yudan,ゆだん
춘화	ポルノグラフィー,猥褻,ポルノ,エーブイ,猥本,アダルトビデオ
엿기름	麦芽
칼리	サンティアゴ・デ・カリ
추행	羞恥心
칼륨	カリウム
명료하지 않은	絶対の
침묵	静けさ
카마	Kāma,カーマ
강가의 층계	ガート
취적	フラストレーション,障害物
무언의	黙々
충칭	重慶
치매	痴呆
침례	バプテスマ,洗礼
최후	オメガ
일산화 탄소	一酸化炭素
무함마드	ムハンマド
치료	療法,治癒力,治療,治癒
칠레	チリ
충치	虫歯,う食
추방	追放,流罪
출발	退去
바가텔	蛇足,バガテル
춘분	春分点
철학	1. 主義,流派 2. 哲学
무인의	むじんな,mujin'na,無人な
총의	協心,コンセンサス,合意,総意
미끼꾼	サクラ
발가락	足指,つま先
도려낸	うんざり
최상	主権
총통	総統
충칭 시	重慶
나사돌리개	スクリュードライバー,ねじ回し
납북전쟁	内乱,内戦
치과	歯科学
정기적수입	収入,shūnyū,しゅうにゅう,実入り
총포	そうほう
친구	1. 友達,友人 2. 親友,友,shin'yū,しんゆう
침강	沈積,沈降,堆積作用
축우	家畜,うし,牛
뎀뿌라	てんぷら,天ぷら,天麩羅,tenpura,テンプラ
생사의갈림길	かわ,川
축삭	軸策
축산	畜産,家畜学
희미한	kasumi
추선	すいじゅん
출산	1. 出産 2. 分娩,san,分身,出産
무자비	残虐行為
촹충	バッタ,きりぎりす
초본	剥奪,凝縮,要約
찰흙	スライム,ぬめり
참회	改寤
엉덩이	1. 尻 2. 尻,ケツ 3. 臀部 4. 腿,股,太股 5. ヒップ 6. 尻,ケツ
체온	気温,おんど,温度,ondo,熱
초밥	鮓,寿司,鮨,壽司,すし
총리	首相,さいしょう
천체	恒星,天体
춘권	春巻き
출국	退去
축구	1. アメリカンフットボール,サッカー,アメフト 2. サッカー,蹴球 3. フットボール
청진	聴診
체조	体育,体操,體育
촉륜	ライトレール,路面電車,トロリーバス
초롱	灯籠,ランタン,提灯
창턱	窓辺
초록	抜粋
최근	最近,新しい
반갑다	幸福な
차후	今後,今や,これ以後
척주	背中
자재 스패너	モンキーレンチ
천정	絶頂,天頂
청어	ニシン
그래프 용지	グラフ用紙
초면	炒麺,チャオミェン
변천의 형	原動力,動力学
촉매	触媒作用
체코	チェコ,チェコ共和国
압생트	苦蓬,アブサン
초유	初乳
초인	神人,超人
자극성의	五月蠅い
수리 논리학	数理論理学
충고	助言
세르비아어	セルビア語
초산	酢酸
엽궐련	たばこ,シガー,葉巻
헤브라이어	1. ユダヤ人,ヘブライ語 2. ヘブライ語
체첸	チェチェン
청춘	夏時,なつ,natsu,夏期,夏,夏時間
타락	墮落
문제의	不可解な
타래	帆環
쿠페	クーペ
어류학	魚類学
탄력	だんせい,弾性,柔軟性,弾力性
퀴즈	試験,クイズ
탄두	弾頭
여단장	だいしょう
복음서의 진리	福音書,ゴスペル
킬로	キロ,キログラム
쿼트	クォート
탈린	タリン
어린이	若者
아인산	亜燐酸
결 혼	1. 結婚式,けっこんしき 2. kon'in,結婚,婚姻,こんいん 3. 結婚式,けっこんしき 4. 結婚式,けっこんしき 5. 結婚,夫婦 6. 結婚,結婚式,けっこんしき
쿼크	クォーク
타륜	ハンドル
아제리어	アゼルバイジャン語
탈륨	タリウム,インジウム
키스	キス
어머니	1. 母,母親,お母さん,おふくろ,母上 2. 母,お母さん,ママ
얼룩말	縞馬,しまうま,シマウマ,ゼブラ
대망이 있는	野心的な
비견하다	競争する,争う,張り合う
건조시키다	乾く,乾かす
일곱개 한벌	shichi,七
키위	1. キウイフルーツ,キーウィ 2. キウイフルーツ,キーウィ 3. キウイフルーツ,キーウィフルーツ,キーウィ
탕산	唐山
훔치다	1. 盗む 2. 盗む 3. 盗む
탐색	スパイ行為
단과대학	大學,学園,大学,学寮,単科大学
탄산	炭酸
발 닦는 매트	バスマット
탈세	脱税
탄소	炭,炭素
탄성	だんせい,弾性,柔軟性,弾力性
바게트	バゲット
퀘벡	ケベック
불완전 골절	侵害
문자의	文字通り,文字上の,逐語的な
퀴륨	キュリウム
밀크 셰이크	ミルクセーキ
회화의	口語の,口語,話し言葉
얼근히 취한	biiru,ビール,麦酒,bīru,ビール1杯
안드로메다자리	アンドロメダ座
웃음꺼리	諺,ことわざ,格言
열망하는	1. 熱心な 2. 熱心な
무익한	無用な,不用な,無駄な
야상곡	夜想曲
성인교육	成人教育,生涯教育
조명도의 국제단위	ルクス
프리메이슨	石工
콩팥	腎,腎臓
코피	鼻血
달콤한	甘い
애써서	痛い,いたい,苦しい
탐구	検討,調査,研究
선견지명	透視
크릴	オキアミ
킬로와트	キロワット
물이든	根深い,nebukai,ねぶかい
크롬	クロム
키리바시	キリバス
불가사의한 물건	奇跡
탄광	石炭鉱区
탁구	卓球
회향풀	フェンネル
탄갱	石炭鉱区
제3인칭	第三者,三人称
탄도	軌道
탈당	背信
여자 괴물	吸血鬼,ヴァンパイア,ラミアー
큰북	バスドラム
탁도	濁り,濁度
타당	順当,正則
탱고	タンゴ
타닌	タンニン
사실상의	仮想
쾌히	進んで,快く
어르다	かわいがる,愛撫する,愛撫,なでる
태극	太極拳,太極
태국	タイ,サイアム,taikoku,タイ国,泰国,たいこく
대초원	パンパ
시 당국	市役所
스트랫퍼드 어펀 에이번	ストラトフォード・アポン・エイヴォン
임시로 쓰는	時折の,偶発的,偶然な,偶,時折
케첩	ケチャップ
발광한	必死な
악마주의자	サタニズム
쾰른	ケルン
커튼	引き幕,とばり,緞帳
예술적인	芸術的な
영웅적 자질	男気,勇気
콘월	コーンウォール
커피	1. 珈琲 2. 珈琲 3. 珈琲,コーヒー豆 4. kafe,コーヒーハウス,珈琲,コーヒー店,喫茶店,カフェ
앞선 것	前機種,zenjin,ぜんじん,前任者,前人
쿨롱	クーロン
실질상의	実用的,経験豊かな,実際的,実践的,実務経験のある,実践的な
동굴 거주인	穴居人
물가 지수	消費者物価指数
켈프	昆布
십자 현수	十字架像
쿠바	1. キューバ 2. 玖馬,キューバ
발굴물	掘削,開削
유물주의	唯物論
크기	1. 程度 2. 大きさ
휩싸다	立ち込める
스테이크	ステーキ
치타	チーター
곡조가 아름다운	多数
코넷	トランペット,口琴
회향병	かいきゅう,懐旧,郷愁,望郷,ノスタルジア,里心
양배추	1. キャベツ 2. キャベツ 3. キャベツ
아오먼	マカオ,アオメン,澳門
서사하라	西サハラ
코돈	コドン
미국령 사모아	アメリカン・サモア,アメリカ領サモア
콘돔	コンドーム
配偶者	配偶者,夫
잔뜩 화내다	子猫
코다	韻尾
커서	カーソル
코더	ソフトウェアエンジニア,プログラマー,ソフトウェア開発者
청훈서	国民投票,レファレンダム
켈빈	ケルビン
대천사	大天使
칠판	黒板
프랑스령 기아나	ガイアナ,仏領ギアナ
존재하다	ある,いる
치환	dainyū,代入,だいにゅう
발광성	光度
캐시미어 숄	カシミア
어려운	入り組んだ,難解,複素
카페	kafe,コーヒーハウス,珈琲,コーヒー店,喫茶店,カフェ
포학한 행위	スターリニズム,独裁政治,幕府,bakufu,独裁
콜리	コリー
사회의 서열	階層
칭호	タイトル,名前,標題
코마	昏睡
의붓자식	継子
권력 기구	階層
쿠거	ピューマ
도둑질	盗み
후치사	後置詞,こうちし
초강대국	スーパーパワー
대신에	...の代わりに,代わり
자기 나라	ぼこく,bokoku,ほんごく,母国,本国,hongoku,祖国
유리 제조	ガラス工
무료한	退屈な
다우림	雨林,熱帯雨林
단어집	語彙
대신의	身代わりの
사다리꼴	不等辺四辺形,台形
만리 장성	万里の長城
메릴랜드	1. メリーランド 2. メリーランド
펀자브 주	パンジャーブ,パンジャーブ州
도개교	跳ね橋
골든 시럽	糖蜜
무리수	無理数
소생시키다	蘇らせる
유리 제품	ガラス工
대왕고래	白長須鯨
커피용 작은 탁자	コーヒーテーブル
퍽아이스 하키	パック
저쪽의 물건	あそこ
봉와직염	蜂窩織炎
반염소의 신	ファウヌス
연결기	端子
아삼어	アッサム文字
집게 손가락	人差し指
교섭 위원	管理者,支配人,ディレクター
대사의 임무	大使館
교양학과	文系
뉴멕시코	ニューメキシコ
다윈설	ダーウィニズム
초조한	ビクビク
대답하여	二度と,再び,又,二度,あらためて,再度,もう一度,って
악상어	ニシネズミザメ
1의 옛 수도	ベリーズ
앵무새	オウム
다육성	肥大,肥満
야영 전도 집회지	キャンプ場,野営地,テント場
연관공	配管工
체펠린	ツェッペリン,軽気球,飛行船
세 대	じんるい,人類,jinrui,人間
어댑터	アダプタ,アダプター
약리학	薬理学,薬学
유혹하다	誘惑する,誘惑
역겨움	嫌気
앨버타	アルバータ州
다의성	多義語,多義性
센 강	セーヌ川
소리가 큰	大声
대답하다	返事する,返信,応答する,返信する,答える
활력 에너지	原動力,動力学
선원등의 수호신	ニコラス
중앙 아프리카 공화국	中部アフリカ,中央アフリカ共和国
대칭적인	対称な
대담하게	思い切って
둘러대기	しゃれ,駄洒落,ダジャレ,語呂合わせ
천체생물학	宇宙生物学
승천 축일	聖木曜日
에콰도르의 수도	キト
대손해	じょうか,掃除
무명지	藥指,薬指
청하다	依頼する
현행 중에 붙잡다	驚かせる
암소 비슷한 영양	ヌー
바른철자	正書法,文字,文字綴り,オーソグラフィー,綴り,スペリング
욕심이없는	1. 利他的 2. 利他的
크레디트카드	クレジットカード
선사하다	あげる
대수층	帯水層
콘스탄티노폴리스	コンスタンティノポリス
촉진제	触媒作用
물망초	勿忘草
남서에 있는	南西
요트조종자	ヨット乗り
대수학	代数式,代数,代数学
어느새	1. 突如,急に,突然,突然に 2. もはや,とっくに,最早,既に
모처럼	1. 特別,特殊に,特別に 2. 特別,一入,ひとしお,別段,特殊に,特別に
코듀로이	コーデュロイ
더럽힘	汚染
다양화	万状
물리학	物理科学
니제르	1. ニジェール,ニジェール川 2. ニジェール
인치 컬럼난	インチ
사려가 없는	迂闊な
연구원	実験者
연구의	実情調査
야물커	キッパ,キッパー
체크어	チェコ語
주의하여	1. じっくり,丹念に 2. じっくり,丹念に
연금사	アルケミスト,錬金術師
제2착자	じてん,jiten
암살자	1. ansatsusha,暗殺者 2. 暗殺者 3. 人殺し,暗殺者
연금술	1. 黄金術,れんきんじゅつ,煉丹術,錬金術,化学 2. 錬金術
그루지안어	グルジア語
무무한	無礼な,失礼,無礼
지 빠귀의류의 새	マネシツグミ
접시 닦는 사람	皿洗い,食器洗浄機,皿洗い機,食器洗い機,食洗気
구조지질학	プレートテクトニクス
육체적 결함	aku,あく
대서양	大西洋
가치 없는	価値のない
양자간의	相互的な,双方
스웨덴의	スウェーデンの,スウェーデン語
굳게 결합시키다	結婚する
비위를 맞추다	お世辞を言う,諂う
스웨덴어	スウェーデン語
만족해 하는	1. ひとりよがりの 2. ひとりよがりの
아시아	アジア
죽고 싶은 생각	死の願望,自殺願望
그 엑스트랙트	ポピー,ケシ色,ケシ,ヒナゲシ
너도밤나무	ぶな,ブナ
애매하다	曖昧
악마 같은	残忍な,悪魔的な
조화되지 않는	不調和な
스칸디나비아	スカンディナヴィア
연기자	演奏家,演奏者,実行者
애끊는 마음	悲しみ
초전도	ちょうでんどう,超伝導,超電導,chōdendō
다시 가공하다	リサイクルする
문병객	hōkyaku,kyakujin,訪客,きゃくじん,客人
여교사	先生
천하게	いつもは,俗,通常,tada,何時も,一般に,日頃,大抵,普通に,ただ,いつも
연구개	軟口蓋
급양하다	ある,いる
앵앵거리다	叱る,しかる
굽히는 사람	プライヤー
목초지	1. 草原 2. 草原
초음파	超音波
유리 장수	ガラス工
성나게 하다	騒がす,いらいらさせる,苦しめる,煩わす
크렘린 궁전	クレムリ
피스타치오	ピスタチオ
아세톤	アセトン
어디나	何処でも,どこでも,dokodemo,どこか
불경제의	不経済な
에놓다	接頭辞
그리스도의 대속	dainyū,代入,だいにゅう
역사화로 장식한	祝われた
가치 있는	かちたかい,価値高い,kachitakai,貴重,大切な
문법책	文法書,文法,ぶんぽう
키릴자모	キリル文字
리투아니아어	リトアニア語
여급사	ウエーター,ウェイトレス,ウェートレス,ウエイトレス
비바람에 상한	風雨にさらされた
닭싸움	tōkei
대성당	大聖堂
끝음생략	語末音消失
후부가늠자	後知恵
화분	植木鉢
현옹	口蓋垂
화법	成句,諺,ことわざ
혈압	血圧
홍보	パブリック・リレーションズ,PR,ピー・アール
후기	後期
학대하다	苛める,虐待する
혼슈	本州,Yokohama
최면술	催眠術,催眠
혹시	万一,ひょっと,tabun,多分,若しや,まんいち
혈종	血腫
혈전	血栓
호수	1. 大洋,海 2. 大洋,水 3. 湖
훠궈	火鍋
혈장	血漿
회랑	回廊,回廊地帯,空中回廊,廊下
환부	障害物,欠点
현재	その内,実際に,今
혐오	1. 憎しみ 2. 存分,憎しみ,憎悪 3. 嫌気
현인	ソロモン
홀뮴	ホルミウム
형석	蛍石
혼미	とまどい
활력	エネルギー
피튜니아	暗紫色,ペチュニア
호박	カボチャ
호반	浜,砂浜
호밀	1. ライムギ 2. ライムギ
향초	1. マリワナ 2. マリワナ,ハーブ
혈석	ニオイムラサキ,ヘリオトロープ,薄紫,キダチルリソウ
학회	学会
홍반	紅斑
형식	雛形
테러리즘	テロリズム,テロ
후궁	ハーレム
혜성	星,彗星
영국령 버진아일랜드	英領ヴァージン諸島,イギリス領ヴァージン諸島,イギリス領バージン諸島
후광	後光
홍역	麻疹
주정뱅이	酒飲み,愛飲家,アルコール中毒者,飲んべえ,小虎,飲兵衛,辛党,飲んだくれ
혼잡	満員
화약	火薬,火藥
신호 발신 장치	ページャ,ポケットベル,ポケベル
홍옥	紅玉
헐한	やすい,yasui,安い,hikui,安価
혹은	...の代わりに,代わり
황소	1. 雄牛,牛 2. 雄牛,牛
회보	ニュースレター,かいし,kaishi,会誌
호의	愛情,愛,aijō
호저	ヤマアラシ
호전	1. 積極的 2. 積極的
환유	換喩法,換喩
환율	為替相場,為替レート
화장	火葬
회상	kioku,記憶,きおく
회사	会社,企業,事業
화음	和音,わおん
훈련	訓練
화폐연구수집	貨幣学
화염	1. 炎 2. 炎,kaen,火,火炎
가극의 상연	オペラ,歌劇団
환영	1. 挨拶 2. ばけもの
험한	突然
화성	1. 火星 2. 火星
환상	ばけもの
매혹하다	1. 引きつける 2. 化かす
향항	中華人民共和国香港特別行政区,香港,ホンコン
형제	同胞
훗날	いつか
후대	おもてなし,持て成し,款待,集客,ホスピタリティー,厚情
정신감응	観念動力,サイコキネスシス,念力,念動力,テレキネシス
화산	火山
화살	1. 矢 2. 矢
화신	1. けしん,化身,ごんげ,権化 2. 化身
푸르스름한	青い
황새	コウノトリ亜科,コウノトリ,鶴,鸛
황색	黄色
호우	大雨,土砂降り
호위	護送船団
혈청	乳清
후두	喉頭
허파	肺,肺臓
현찰	現金,硬貨
군청 청사	裁判所
화천	天空,tenkū,てんくう
황진	sunaarashi,砂嵐,すなあらし
효소	酵素
의사 속기자	ジャーナリスト,記者,リポーター,報告者
흑인지대	黒帯
회오	改寤
회염	喉頭蓋
홍콩	中華人民共和国香港特別行政区,香港,ホンコン
더블린	ダブリン
협회	クラブ,社会
회장	議長,委員長,主席
획일	画一性,統一性,普遍性
회음	会陰
호텔	1. 舎,居酒屋,宿屋 2. ホテル,旅館
흰곰	白熊,北極グマ,ホッキョクグマ
황어	ヒメハヤ
혈통	家系図
저녁 식사	夕食
알베도	アルベド
후미	1. 小川,流れ,入江,いりうみ,いりえ,入海,川,irie,iriumi 2. 江,入り江
홍진	紅斑
학위를 받다	始める
흉골	胸骨
황자	おうじ,ōji,王子
홍차	1. 茶 2. 紅茶
효성	敬愛
형판	雛形
휘도	光度
펩시콜라	ペプシコーラ
황족	ひめ,ōjo,姫,王女,hime,おうじょ,王妃
호칭	あだ名,名前,固有名詞
홍해	紅海
세탁 소다	sōda,ソーダ
홍학	フラミンゴ
홍합	ムラサキ貝,イガイ,ムール貝
흩다	散らす,ばら撒く
테이프 레코더	テープレコーダー
희한하게	稀に
훈장	メダル,勲章,賞牌
아버지	パパ,父親,お父さん,父上,父,親父
더브늄	ドブニウム
화훼	被子植物
몹시 놀라게 하는	仰天するような
홈통주둥이	ガーゴイル
후식	デザート
화탁	視床
흑단	コクタン
뭄바이	ムンバイ
혼합	1. 混交 2. 混合
초라한 작은 방	屋根裏部屋
혼혈	1. 混血 2. 混血
부끄러이 여겨	恥じている,恥ずかしい
후예	子種,子孫
해명	擁護,立証
할복	せっぷく,腹切り,切腹,自殺
수월하게	実際に,現在,現在は
항문	肛門
해면	海水準
해먹	ハンモック
항모	航空母艦
해마	セイウチ
한번	すぐに
덧머리	入れ毛,かつら
아바나	ハバナ
한발	旱魃
평균 예상 수명	平均余命,平均寿命
헛간	納屋,廐
허구	架空,小説
푸한	ふかふかした,ほっこり
학명	学術用語,術語,専門語,命名法
뿌리깊은	根深い,nebukai,ねぶかい
필법	にゅうぼく,書道,筆,カリグラフィー,書法,nyūboku,入木
푸른 잎	緑,みどり,midori
행동	振舞い
하마	カバ,kaba,河馬
허가	承知,許可
할례	包皮切断,割礼
풍토	気候
필명	筆名,雅号,ペンネーム
하렘	ハーレム
푸틴	プーチン
표피	表皮
해달	海獺,ラッコ
피망	ピーマン,パプリカ
해당	解糖系
피막	そうほう
하안	川沿い,川岸,川端
필적	にゅうぼく,書道,筆,カリグラフィー,書法,nyūboku,入木
대역죄	裏切り
해석	聖書釈義
공동 연구하다	(敵に) 協力する,共同して働く,協力する
항상	1. いつも 2. 決まって,かならず,renjitsuren'ya,連日連夜 3. いつも 4. 絶え間なく,いつも
협곡	1. 峡谷 2. 峡谷
필연	nyūyō,ひつよう,入用,にゅうよう
항성	恒星
커스터드과자)	カスタード
햇빛	日光,nikkō,にっこう,光,太陽光,たいようこう
해산	分娩,san,分身,出産
피자	ピザ,ピッツァ
핵산	核酸
피임	避妊
해삼	海鼠
필요	1. nyūyō,ひつよう,入用,にゅうよう 2. 必要,nyūyō,入用,にゅうよう
혈관	血管,けっかん
혈괴	血栓
하슘	ハッシウム
현금	現金,硬貨
행복	幸い,幸せ
함성	スローガン,標語
희망하다	希望する,望む
하소	煆焼
학설	主義,流派
하수	水管
할선	セカント
헤너	ヘンナ
면허장	卒業証書,ディプロマ
불안정하다	揺らす,震える,ぶれる,ブラブラさせる,ブラブラする
학살	修羅,虐殺,大虐殺,大量虐殺,惨殺
해발	海水準
해박	博学,学
해변	浜,砂浜
단풍 시럽	メープルシロップ
기상학자	気象学者
햄릿	ハムレット
피크	ピック
화기	銃,火器
하천	かわ,川
황경	経度,經度
피터	ペテロの手紙,ペトロス,ペテロ,ピーター
겁 많은	kowai,恐い
다운로드하다	ダウンロードする
활기	エネルギー
핵자	かくし,核子
화가	アーティスト,画家,芸術家,作家
환경	1. 辺り,周囲 2. 前後関係,状況,文脈
환관	宦官
핵종	同位体,同位元素
향수	かいきゅう,懐旧,郷愁,望郷,ノスタルジア,里心
해적	海賊
헬륨	ヘリウム
어깨의	肩胛骨,肩甲骨
비가 많은	湿った
피차	ピザ,ピッツァ
해안	1. りんかい 2. Riku,陸,海岸 3. hama,海辺,沿岸
향상	1. きょうか 2. かいぜん
해우	マナティー,マナティ
헤롯	ヘロデ
행성	星,惑星
학우	クラスメート,級友,同級生,クラスメイト
암모늄	アンモニウム
핵심	ネーブル,臍
피지	フィジー
그림자 그림연극	影絵
호격	呼格
하인	家来
허리	腰部
허울	建前,ファサード
하품	欠伸する
허위	虚偽の
호몔	ホメリ
화랑	画廊,美術館
황녀	ひめ,ōjo,姫,王女,hime,おうじょ,王妃
회교	イスラム教の
화두	アイロン
혼란	1. 病気 2. 混乱
핑퐁	卓球
아랑곳하지 않는	さりげない
회귀	再帰
형법	刑法
혼례	結婚式,けっこんしき
줌 렌즈	ズームレンズ
하키	1. ホッケー 2. アイスホッケー,ホッケー
지리학 책	地理学,地理,chiri
합친	連合した
해초	海草
대원수	総統
컨설턴트	顧問
홀딩	もち,保持
회개	改寤
혈병	血栓
화덕	レンジ,オーブン,ストーブ
근심하여	怖い
협력	共和,協働
어깨뼈	肩胛骨,肩甲骨
허수	虚数,複素数
함축	含意
항체	抗体
협만	フィヨルド
휠체어	車椅子
담자균	担子菌
이산화 실리콘	ケイ素二酸化物
히피	ヒッピー
시인 기질의 사람	kajin,しじん,haijin,詩人,作者,shijin
휴지통	くずかご
마리화나	1. マリワナ,ハーブ 2. マリワナ 3. マリワナ 4. マリワナ 5. マリワナ 6. マリワナ,インド大麻,大麻
아비장	アビジャン
매끈매끈한	subesube,すべすべ
돌고래	1. 海豚,イルカ 2. ネズミイルカ
엷은 안개	ガーゼ
흥분 상태	強風
흑요석	黒曜石
페널티킥	けいむしょ,ペナルティーキック,かんごく,刑務所,監獄,ダンジョン
무선국	ラジオ放送局
초심자	初心者
한창때가 지난	旧弊,昔風,旧弊な
마르코프 연쇄	マルコフ連鎖
인품이 좋은 사람	おうじ,ōji,王子
도깨비	妖精,仙女
과장하다	誇張する,誇張
습관이 되는	常習的,中毒性
최루약	催涙ガス
총선거	総選挙
보디 빌디	ボディビル
프로그램 언어	プログラミング言語,プログラム言語
미워하다	1. 嫌う,憎む,いやである 2. 嫌い
도금양	ギンバイカ
초신성	超新星,ちょうしんせい
대양주	オセアニア,大洋州
공시하다	通告,知らせる
익숙하지못한	下手な
총살대	銃殺刑執行隊,銃殺隊
증기 기관	蒸気機関
과대시하다	誇張する,誇張
서로 죽이는내분의	1. 内輪もめの 2. 内輪もめの
단위체	モノマー
나타내다	1. 現す 2. 言う,証明する 3. 証明する 4. 見せる 5. 言う 6. 見せる
해소할 수 있음	溶解性
희롱	笑い
황혼	黄昏,薄明,日暮
휘석	輝石
황해	黄海
자제할수 없음	失禁
황하	黄河
흐림	濁り,濁度
모테트	モテット
개착 2굴	掘削,開削
흉상	胴,胴体
저축은행	貯金箱
최루탄	催涙ガス
회화	話し,カンバセーション,談話,かいわ,会話,話,対話
흑빵	ライ麦パン,パン
후치	後置詞,こうちし
회한	1. 良心の呵責,改寤,悔悟 2. 改寤
단위의	ユニタリ
액막이	破魔,悪魔払い
휴전	休戦,停戦
흉악	残虐行為
성모 마리아	マリア,メアリー,マリー
얇은 사의 일종	グレナデン・シロップ
히숍	綿棒
중등학교	高等学校,高校
양동이	バケツ
흑점	太陽黒点
흑인	黒人
흉조	縁起
다음자	多音語
흰쌀	白米
흑연	石墨,グラファイト
다음에	それ,それから,その後,後で
후회	1. 良心の呵責,改寤,悔悟 2. 改寤
최후의 말	最後 通牒
하이라이더	蛍光ペン
단일체	個人主義
공중수송	航空輸送,空輸
시킴 주	シッキム州
휙획	雁木,ジグザグ
에게해	エーゲ海
무상한	短命な,はかない,束の間の
팔레스타인	パレスチナ領土,パレスチナ
독일연방공화국	西ドイツ,ドイツ
운동경기의	強壮な
무성의	無性の
흡착	吸着
못된 장난	悪戯,akugi,あくぎ,いたずら,itazura
개똥벌레	hotaru
힐책	告発,容疑,告訴,ようぎ,言いがかり
무선의	無線,ワイヤレス
힘찬	さかん
수륙 양용의	水陸両用
만리장성	万里の長城
무서운	1. 酷い,凄い 2. 身の毛もよだつ 3. 猛烈,osoroshii,おそろしい,ひどい 4. 恐ろしい,憎い
힘줄	腱,筋
양딸기	ichigo,いちご,苺,イチゴ
산화칼슘	石灰
흔히	1. 稀に 2. しばしば
차용번역	翻訳借用
회전;나선	回転
흑해	黒海
아브라함	アブラハム,エイブラハム
대류권 계면	対流圏界面
새총	スリングショット
불협화음	不協和音
사태	山津波
상치	1. 萵苣,レタス 2. 萵苣,レタス
선신	マツダ
사탄	サタン,魔王
성사	秘跡
생물 진화	進化論
상처	1. 傷 2. 負傷,怪我,けが
생쥐	1. ハツカネズミ 2. マウス
설사	下痢,げり
소듐	ナトリウム
소득	収入,shūnyū,しゅうにゅう,実入り
서수	序数詞
민들레속	たんぽぽ
신앙 고백자	教授
서약	せいやく
조직화 하다	体系
소란	1. 混乱 2. 喧々囂々,騒ぎ,騒音,騒動,猥雑
셰리	シェリー酒,シェリー
성서	聖書
사통	淫売,売春,baishun,買春,切り売り主義
삼투	浸透
서울	京城,ソウル
소름	鳥肌
석유	1. 石油,灯油,原油 2. 灯油
섭씨	セ氏,摂氏,セルシウス
선원	水兵,船員,ジャック,水夫
삼판	サンパン,三板
소련	ソヴェト連邦,ソビエト連邦,ソ連,蘇連,ソビエト
속력	そくど,速さ,速度
젖짜는 여자	乳しぼりの女
산파	助産婦
세슘	セシウム
산패	酸性化
선양	瀋陽,瀋陽市
서예	にゅうぼく,書道,筆,カリグラフィー,書法,nyūboku,入木
선언	檄文,檄
석영	結晶,石英,水晶
섹시	セクシーな,セクシー
선열	伝染性単核球症
손목	リスト,手首
사형	死罪,死刑,極刑
속물	スノッブ
소문	1. 情報 2. 噂 3. うわさ,噂 4. うわさ,噂
새틴	繻子,サテン
성욕	食欲
아랍어	アラビア語
산화	酸化
상표	商標
섞인	交じった,混合した
설욕	擁護,立証
사해	死海
선의	腺状
상패	メダル,勲章,賞牌
쇄도	波の打ち寄せ,洪水,氾濫
소명	仕事,職業,天職
선적	つみに,tsumini,積荷
석묵	石墨,グラファイト
주크박스	ジュークボックス
설명	説明
사주	さす,す
삼월	さんがつ,3月,sangatsu,３月,三月
서문	じょし
상업	ヘルメース
설마	必ず,zehi,正に,是非,その通り,屹度,実に,確かに,確実に,きっと,ぜひ
와이 셔츠	シャツ,Ｔシャツ
산적	hito,ひと
살인	謀殺,殺人,殺害
석면	アスベスト,石綿
사제	司祭
사점	真中
삭제	去勢
소곡	小唄,こうた
사전	1. 辞書,じびき,字引,jibiki,字書,語彙,字典 2. 語彙 3. 辞典,シソーラス,辞書,類語辞典,語彙
사자	しし座,獅子,ライオン
사장	議長,委員長,主席
서막	じょし
알라닌	aranin
산욕	産褥
소각	火葬
새장	鳥かご
살짝	静かに,安静に
선별	トリアージ
쿠리치바	クリチバ
성명	コミュニケ
아레스	アレス
송곳	突きぎり
세륨	セリウム
은행 통장	通帳
도서관원	司書,図書館員
선반	旋盤
서법	にゅうぼく,書道,筆,カリグラフィー,書法,nyūboku,入木
셀렌	セレン
선미	船尾,尻,ケツ
상인	1. 商人,shōnin 2. 商人,shōnin,しょうにん
상응	相同性
사직	退位
사진	写真
피라미드	ピラミッド
비잔티움 제국	東ローマ帝国
상원	元老院
세로	経度,經度
소기	メタン
세례	1. バプテスマ,洗礼 2. バプテスマ,洗礼
선물	寄付,プレゼント
소금	1. 食塩,塩 2. 食塩,塩
설비	装置,機器,kiki,きき
성병	性感染症,karyūbyō,花柳病,かりゅうびょう
손녀	1. mago,孫 2. 孫娘
사촌	いとこ,従兄弟,従姉妹
성보	遺物,聖遺物
소녀	1. 少女,女の子 2. 少女,女の子
송금	そうきん
송구	ハンドボール,送球,ハンドリング,ハンド
솔로몬 제도	ソロモン諸島
성문	声門
대명사	代名詞
안락사	オイタナシー,安楽死
소동	1. 喧々囂々,騒ぎ,騒音,騒動,猥雑 2. 混乱
선생	1. 教授 2. 先生 3. 教師 4. 先生 5. 先生
쇄골	sakotsu,鎖骨,さこつ
속담	1. 成句,諺,ことわざ 2. 諺,ことわざ,格言
생존	存在
사칭	おうしゅう,押収,ōshū
성분	料理材料
소다	sōda,ソーダ
세번	三回
생일	生日,生年月日,誕生日,誕辰
치마분	練り歯磨き,歯磨剤
설날	元日,元旦,新年,gantan,ganjitsu,がんじつ,がんたん
세기	含意
대리의	身代わりの
일되는 올벼의	1. soujuku,早熟,そうじゅく 2. soujuku,早熟,そうじゅく
일반적으로	1. いつもは,俗,通常,tada,何時も,一般に,日頃,大抵,普通に,ただ,いつも 2. 一般に
새벽	1. akegata,暁,夜明け,あけがた,明け方 2. 夜明け,明け方
선단	頂点
성냥	可燃物
사산	死産
서도	にゅうぼく,書道,筆,カリグラフィー,書法,nyūboku,入木
생물	せいぶつ,生物
사서	辞書,じびき,字引,jibiki,字書,語彙,字典
산소	酸素
존경하다	めでる,かんしんする,kanshinsuru,感心する
선두	前線
샛별	明けの明星
바레인	バーレーン
사수	1. 射手 2. 射手,shashu,しゃしゅ
사실	実は,実際には
성단	星団
산수	算数,さんすう,算術
세뇌	洗脳
상상	推測
상사	軍曹
선디	パフェ,サンデー
성당	聖骨箱
마지못해	しぶしぶ,否々乍ら
데마를 퍼뜨림	扇動,デマ
못된 계집	売春婦,すべた
석랍	パラフィン
상식	常識
사업	1. きぎょう,企業,kigyō 2. 会社,企業,事業
사열	調査,点検
마사지 하다	マッサージ
사월	四月,4月
석류	石榴,柘榴,ザクロ
사랑	愛情,愛,aijō
메카 순례	メッカ巡礼,ハッジ
네델란드어	1. オランダ語,オランダ人,蘭語 2. オランダ語,蘭語
사람	1. 人 2. 人 3. 人類,人間 4. せいぶつ,生物 5. 個人,人 6. 人,人間 7. じんるい,人類,jinrui,人間 8. 人物,じんぶつ,jinbutsu 9. 動物 10. どうせいあいしゃ 11. 人
월귤나무의일종	ブルーベリー
샌들	サンダル,草鞋
사망	死ぬ,死
서가	本棚,書架,shoka,書棚
매훈련법	鷹狩り
선고	裁決
대마초	マリワナ,インド大麻,大麻
석공	石工
석관	石棺
살림	生活
산맥	sanmyaku,山脈
사명	用事,shimei,使命,しめい
사면	斜面
선객	乗客
취임식	就職
산문	散文
양금사	鳥類飼育場
삼림	森林,しん
섬게	ウニ,海胆,雲丹
석궁	石弓
선구	ツアーコンダクター,宅配会社,メッセンジャー,旅行添乗員,つかい,運送会社
만족하게	順調に
성골	遺物,聖遺物
사본	草稿,稿本,写本,マニュスクリプト,手書き原稿,稿
사복	市民
성경	聖書,虎の巻
기증하다	寄付する
오드콜로뉴	ケルン
생략	……,省略記号,…
성궤	仮庵,幕屋,シナゴーグ
산불	森林火災
성과	手柄,成果,達成,到達,遂行
성교	性交
색맹	色盲
센강	セーヌ川
발레곡	バレエ
세균	1. バクテリア,細菌,bakteria,きん 2. 微生物
세금	税金,税
입술연지	口紅,リップスティック
박람회	万博
성기	性器,生殖器,恥部,みと
수염	1. 鬚,口髭,髯,口ひげ,髭 2. 髭
술어	学術用語,術語,専門語,命名法
십계	モーセの十戒
습도	湿度
수원	1. 泉 2. 泉
야누스	ヤヌス
수액	脳脊髄液,髄液
소화	1. 消化 2. 消化
신교	プロテスタント
수연	モリブデン
숙어	1. 成句,諺,ことわざ 2. 諺,ことわざ,格言
수업	授業
승낙	承諾,承服,しょうふく
시거	たばこ,シガー,葉巻
아르곤	アルゴン
단층 형성	断層
시계	1. 時計 2. 走行距離計,クロック,とけい,tokei,時計,置き時計
소행	手工芸
시골	田舎,田園
술술	さらさら,さらさらと,つるつる
술수	器用さ
순시	警備
숭상	畏敬
가늠쇠가 없는	盲目
시가	実勢価格,相場
시대	1. 時代 2. 時代,じだい
충충한	不透明な
숫자	すうじ
신념	信奉,信仰,宗教,しょしん,かくしん
시내	1. おがわ 2. 小川,流れ,入江,いりうみ,いりえ,入海,川,irie,iriumi
수종	浮腫,水腫
수음	自慰,オナニー,マスターベーション,オナニ
수의	獣医
생물학적 정량	バイオアッセイ
수은	1. 水銀 2. 水銀
순익	利益
수입	輸入
쇠약	萎縮
소켓	コンセント,電源
수부	水兵,船員,ジャック,水夫
수분	じゅふん,受粉
흔들다	ぐらぐら動かす
수바	スバ
수박	スイカ,西瓜
치루탄	ざくろ,榴弾,グレネード,りゅう弾
순무	蕪,カブ
소포	膀胱
수수	1. キビ 2. キビ 3. モロコシ
수소	水素,すいそ
순사	殉教
수성	メルクリウス,水星
습기	1. 水分,湿気 2. 湿度
손톱	1. 爪 2. 爪
수색	調査,研究
수상	首相,さいしょう
습관	伝統,でんとう
소택	沢,湿原,湿地
뒤에 둠	後置詞,こうちし
승객	乗客
늘임표	フェルマータ
쇠미	墮落
속옷	shitagi,したぎ,下着
마르크스주의	マルクス主義
세탁	じょうか,掃除
서표	ブックマーク,栞
시로코 바람	sunaarashi,砂嵐,すなあらし
서풍	微風
소위	中尉,副官,少尉
소유	もち,保持
여러 가지이름으로	色々
소음	喧々囂々,騒ぎ,騒音,騒動,猥雑
셔츠	シャツ,Ｔシャツ
수마트라섬	スマトラ
센터	中堅手
속임	まがいもの
소재	原料
설표	雪豹,ユキヒョウ
쇄석	ゴミ
수대	黄道帯
순대	腸詰め,ソーセージ
수도	1. 首都 2. to,しゅふ,町,shufu,都市,首府,主要都市,京
악랄한	akumyōdakai,あくみょうだかい,悪名高い
추수감사절	感謝祭
손에 넣다	購入する
손질	じょうか,掃除
송이	星団
성향	食欲
무분별하게	1. 無暗に 2. 無暗に
숙맥	うすのろ,でくのぼう
숙모	おば,小母さん,おばさん
선하	つみに,tsumini,積荷
손자	1. 孫息子 2. mago,孫
바라다	1. 希望する,望む 2. まつ,予想する,望む,期待する,待つ,予期する 3. 望む 4. こう,請う
세트	セト
송영	頌栄
수로	しょくどう,食道
수련	睡蓮,スイレン
실험에 의한	実験的
설화	物語,ナレーション
순록	トナカイ
소지	苦境,窮地
세평	名声,評判
수권	水圏
전제 정치	スターリニズム,独裁政治,幕府,bakufu,独裁
순교	殉教
샴 고양이	シャム
세제	洗剤
순경	keisatsukan,けいかん,警官,けいさつかん,keikan,警察官
수국	紫陽花
수구	水球,ウォーターポロ
공기의 요정 같은	軽い
서체	にゅうぼく,書道,筆,カリグラフィー,書法,nyūboku,入木
상피	近親相姦,インセスト
상해	上海,上海市
소변	1. ピー,尿,おしっこ,小便 2. 尿,小便
성위	集まり,アステリズム,星座絵,星群,一群,せいざ
상품	品,物品,shōhin,品物
속박	拘束
성좌	バチカン市国
수고	労働
수계	水圏
수갑	手錠
성전	聖書
수간	こうもんせいこう,アナルセックス
세자	おうじ,ōji,王子
뱃놀이	ヨット遊び
소식	情報
성취	手柄,成果,達成,到達,遂行
신의 없음	不忠実
숙녀	奥様,fujin,クイーン
소수	素数
선택	1. 選挙 2. 選択肢
수달	川獺
수다	会話
쇠똥	スラグ,鉱滓
비정상인	異常な,不自然な
야기하다	引き起こす,発生させる
치료소	病院
성체	秘跡
소송	訴訟
소성	煆焼
손상	侮辱する
소설	架空,小説
생활	1. 生活様式 2. 存在
자극하다	1. 動機を与える 2. tokimeki
식탁	食卓,机,テーブル,キッチンテーブル
습한	湿った
카드뮴	カドミウム
헤로도투스	ヘロドトス
식통	美食家,料理通,グルメ,食通
문학사	文学史
단명한	短命な,はかない,束の間の
박물관	博物館
신토	1. 神道 2. 神道
승화	昇華
고름이 나오다	化膿する,ただれる,爛れる,化膿
완만하게	そっと
프리시안어	フリースランド語
시초	創世期
식초	1. 酢 2. 酢
신청	求婚
시청	市役所
스팸	スパム,迷惑メール
시찰	調査,点検
그 결과로서	1. したがって 2. それ,それから,その後,後で
썰매	橇,ソリ
100만 사이클	メガヘルツ
아리아	詠唱,アリア
안마당	nakaniwa
슬픈	悲しい,悲惨な
공중부양	空中浮遊,空中浮揚
실체	実体
희극의	可笑しい
우랄 어족	ウラル語族
희귀한	稀な,드문
신정	神政政治
신전	聖骨箱
실재	実体
싸얌	タイ,サイアム,taikoku,タイ国,泰国,たいこく
신조	教義
실제	1. 実際に,実際性 2. 実は,実際には
시인	kajin,しじん,haijin,詩人,作者,shijin
시장	1. デパート 2. 市場
시저	カエサル,シーザー
신임	信頼
실직	失業
심줄	腱,筋
입회시키다	登録する
헝가리어	1. ハンガリー語 2. ハンガリー語
실존	存在的
슈퍼	スーパーマーケット
시짱	チベット自治区,チベット,西蔵
스키	スキー
아마의	亜麻
싸움	1. レスリング,戦争 2. 争い 3. 会戦,ikusa,レスリング,戦い 4. レスリング,戦闘
무한히	無限
이쑤시개	ようじ,楊枝,爪楊枝
습지	沢,湿原,湿地
썰다	切る
취업일	週,週間
썩다	1. 腐る 2. 腐る 3. 腐る
실업	失業
식욕	食欲
아메바	アメーバ
쌍성	連星,二重星
신용	信奉,信仰,宗教,しょしん,かくしん
시월	十月,神無月,じゅうがつ,10月
알코올의	アルコール入りの
신어	1. 新語 2. 新造語,新語,造語
악마인	残忍な,悪魔的な
시연	ししゃ
신안	機器,小物,こもの
신앙	信奉,信仰,宗教,しょしん,かくしん
식사	1. 昼食 2. 食事 3. 軽食,間食,スナック 4. 昼食
시상	視床
시세	実勢価格,相場
감수 분열	減数分裂
미남 배우	áidoru
신속	速度
식성	上顎,口蓋
바리톤	1. バリトン 2. バリトン 3. バリトン
콤팩트 디스크	CD,シーディー,ＣＤ,ディスク,コンパクトディスク
신성	神聖
습자	にゅうぼく,書道,筆,カリグラフィー,書法,nyūboku,入木
실수	文法違反
악마교	サタニズム
심상	映像化,可視化
슈와	シュワー
숨통	気管
바마코	バマコ
신문	1. 新聞 2. 新聞 3. 新聞 4. 新聞 5. 報道
수판	そろばん,頂板,算盤
심문	異端審問
수표	小切手
심방	hari
수학	数学,數學
수필	話々,世間話
아마도	万一,ひょっと,tabun,多分,若しや,まんいち
보통 휘석	輝石
수프	スープ
코발트 그림물감	コバルト
수화	手話
쌍놈	くそったれ
식량	食材
작은 둔덕	小山,丘
시럽	みつ,シロップ,糖蜜
시련	患難時代
신랑	1. kare,カレ,カレシ,kareshi,かれし,ボーイフレンド 2. しんろう,花婿,新郎 3. しんろう,花婿,新郎
쉬와	シュワー
아리만	アンラ・マンユ
신뢰	頼り
실련	失恋,ブロークンハート
수탉	雄鶏
실로	そう,ああ,ええ,うん
실론	セイロン,スリランカ
쇼핑	買い物　
와플<과자>	つまらない話,ワッフル
실망	遺憾,失望
증가하다	増やす,増す,増加する
점잔빼며 걷는	小刻みな
식도	しょくどう,食道
스목	仕事着
스모	相撲
수착	収着
알레포	アレッポ
승리	1. しょうり,kachi,勝利,勝ち,ゆうしょう 2. 達成,業績
밀착 인화기	印刷業者
무향실	霊安所,遺体安置所
수축	狭窄
수출	ゆしゅつ,輸出品,輸出,yushutsu
싸다	さやに入れる
최후로	tsui ni,終に,遂に,竟に,ついに
꾸며낸 것	架空,小説
몹시 추운곳	冷蔵庫
칸델라	ろうそく
얼간이	うすのろ,でくのぼう
단백석	オパール
계산용의	計算高い,keisandakai,けいさんだかい,計算可能な
대륙붕	大陸棚,tairikudana,たいりくだな
아모스	1. アモス書 2. アモス書
무한대	無限
쓸개	胆嚢
어슬렁거리다	散歩する
산아 제한	家族計画
알맞은	安い,手ごろな
취약권	アセノスフェア
대리모	代理母
카스피 해	カスピ海
즐겁게하다	楽しませる,もてなす,歓待する
그대로인	一切の
단백질	蛋白質
어긋남	違い
헤로도토스	ヘロドトス
알리다	1. 知らせる 2. 通告,知らせる
종합의사	ゼネラリスト,ジェネラリスト
우랄산맥	ウラル山脈,ウラル
오해하게 하는	欺瞞的な
뉴클레오티드	ヌクレオチド
시시덕거림	軟派
1인승 가마	駕篭
시기하는	羨ましい
수여하다	授与する
노동조합	労働組合
화려한것의 무리	集まり,アステリズム,星座絵,星群,一群,せいざ
어린이성	子供時代
수평 낙하	パンケーキ
심한	酷い,凄い
심황	ウコン
댈러스	ダラス
축치어	チュクチ語
시합	トーナメント
박테리아	バクテリア,細菌,bakteria,きん
암류권	アセノスフェア
시행	強制,実施
신피	上皮
신학	1. 神学 2. 神学 3. 神学,しんがく
캐나다	Kanada,加奈陀,カナダ
신혼	蜜月,新婚旅行
쏘련	ソヴェト連邦,ソビエト連邦,ソ連,蘇連,ソビエト
카다프	カーディフ
신화	伝説,神話
실패	堕胎,流産,失敗
단락부호	段落
췌장염	膵炎
심판	1. レフリー 2. レフリー 3. レフリー 4. レフリー
변소	かわや,手洗い,べんじょ,厠,便所,化粧室,憚り
법원	裁判所
벌이	ベーコン
생태학자	環境学者
흰개미	白蟻,シロアリ
박학	博学,学
바흐	バッハ
범인	罪人,犯人
벌족	家族
볼모	hitoshichi,人質,ひとしち
범위	1. 程度 2. 地平線
아름다운 물건	うた,詩的表現
다신교	多神教
방향	臭気,匂い,香り
방해	1. 障害物 2. 障害物 3. 障害物
보복	1. 復習 2. ふっきゅう,復習
보병	歩兵
발효	発酵
병상	toko
안도라	アンドラ,アンドラ公国
병사	飼葉
부관	中尉,副官,少尉
백합	百合,ユリ,yuri
북경	北京,ペキン
방화	放火
서양 호박	1. zukkīni,ズッキーニ 2. ズッキーニ 3. ズッキーニ
범주	部門,家族
부근	近所,概算,近傍,近似量
북극	北極
풍선난초	カリプソ
부기	簿記
벤젠	ベンジン
분광	分光特性,スペクトル
버찌	さくらんぼ,桜ん坊,桜桃
부귀	繁栄
불경	冒涜
의치 기공사	歯科技工士
벤진	ベンジン
벽옥	碧玉
데네브	デネブ,夏の大三角形
벽장	todana,とだな,戸棚,食器棚
병약	衰弱
보석	1. 宝石 2. ルビー 3. たま,宝玉
복사	1. レプリカ,複製,写し,模造品 2. ファクスを送る
비잔티온	ビュザンティオン
회의심	かいぎ
변종	突然変異体,突然変異
복수	1. 復習 2. ふっきゅう,復習 3. 復習
보수	1. サラリー,給料,きゅうりょう 2. 報酬 3. ほうしゅう 4. 報酬
변절	背信
병원	病院
버킷	バケツ
분노	こうしん
벽지	壁紙
버터	にゅうらく,bata,バター
더듬기	1. 吃り 2. 吃る,どもり
부두	波止場
불독	ブルドッグ
보오	ボー
희가스	貴ガス,希ガス
방사능 폐기물	放射性廃棄物
회음부	会陰
보육	かんご
보이	ベルボーイ
복음	福音
볶은	スクランブルドエッグ,スクランブルエッグ
복장	1. 衣服,服,衣類,fuku 2. 衣装 3. 衣装,衣類,ifuku,いふく 4. 衣装
제임스 본드	ジェームズ・ボンド
복제	レプリカ,複製,写し,模造品
수호천사	守護天使
조각 그림 맞추기	ジグソーパズル
보존	保持,保存
암흑 물질	暗黒物質
부레	膀胱
봄의	若々しい
봉우	犎牛,瘤牛
번호	電話,電話番号
보지	いんもん,inmon,陰門
어린시절	子供時代
보증	保証
복지	幸福,福祉
병치	並列
뎅그열	デング熱
버마	ミャンマー,ビルマ
꼭두각시	偶人,操り人形,絡繰り人形,パペット
벌레	虫螻
백신	疫苗,痘苗,ワクチン
미진	原子,元素
반역	裏切り
배신	裏切り
민중	質量
민족	国籍,こくせき
배영	背泳
재빠른 손재주	手品
배열	集まり,アステリズム,星座絵,星群,一群,せいざ
본국	ぼこく,bokoku,ほんごく,母国,本国,hongoku,祖国
발전	進化
보급	飛散,hisan,ひさん,分散,拡散
배알	1. 糞袋,腸,大腸,ちょう,腸管,糞嚢 2. 肝
발음	発音
방언	方言,ほうげん,訛り
배를린	ベルリン
밝은	明るい,あかるい,明い,akarui
밝음	光度
보고	kura,倉
앵귈라	アンギラ
뮤지컬	ミュージカル
무시무시한	身の毛もよだつ
밥줄	しょくどう,食道
백인	白人
방정	順当,正則
발진	蕁麻疹
병동	パビリオン
마케도니아의왕	アレキサンダー大王,アレクサンダー
인위적으로	人工的に
방위	方位角
바지	ズボン,パンツ
바질	1. バジリコ 2. バジリコ,バジル
배지	培地
배짱	度胸,勇気,きも
벼룩	ノミ,蚤
변량	確率変数
밴조	バンジョー
봉급	サラリー,給料,きゅうりょう
병든	病気
봉기	反乱,ほうき,hōki,暴動
백조	白鳥,鵠
보도	舗装,舗道,歩道
타나토스	タナトス
발췌	抜粋
벨벳	ベルベット
대수롭지 않은	些細
이야기거리	話題,主題
벌새	ハチドリ
미트	手袋
형사 피고인	罪人,犯人
복도	1. 回廊,回廊地帯,空中回廊,廊下 2. 美術館
병렬	並列
미터	1. メートル 2. メートル 3. メートル
바친	seinaru
본능	本能
오줌누다	小便をする,おしっこをする
보다	1. 見る,注視する 2. 見る,注視する 3. 見る
법석	お祭り騒ぎ
박탈	民営化
티베트 자치구	チベット自治区,チベット,西蔵
변발	お下げ
범선	帆船,はんせん
벽보	張り紙,ポスター
배추	白菜,ハクサイ
다수결	人口調査,戸籍
미풍	強風
별명	1. あだ名 2. みょうじ,苗字,姓氏,あだ名,名字,姓 3. 仮名,あだ名,源氏名,かな,假名 4. あだ名,異名,偽名
바쿠	バクー
밍크	ミンク
결정꼴의 마약	アイスクリーム,aisukurīmu,アイス
뱃짐	つみに,tsumini,積荷
바퀴	車輪,輪
본래	勿論,もちろん,当然
동성애의 사람	同性愛,dōseiaisha,dōseiai,性的指向,どうせいあい
방탕	酒色,淫乱,淫逸,放蕩,漁色
벌써	もはや,とっくに,最早,既に
미학	美学,美學
방콕	バンコク
백치	頓痴気,低能者,間抜け,baka
맨그로브	紅樹林,マングローブ
배치	集まり,アステリズム,星座絵,星群,一群,せいざ
큰 천막	パビリオン
라이위스키	ライムギ
반토	アルミナ,酸化アルミニウム
아니오	1. とも,……とも,いいえ 2. いいえ
보륨	ボーリウム
산악 지방	sanmyaku,山脈
보름	満月
보리	1. オオムギ 2. 大麦,麦,オオムギ
캥거루	カンガルー
과테말라	1. ナイジェリア 2. グアテマラ 3. グアテマラシティ,グアテマラ
복막	腹膜
흑멧 돼지	イボイノシシ,疣猪
혼탁도	濁り,濁度
발표	プレゼンテーション
큰 차양	パビリオン
보루	要塞
붉은 행성	火星
번역	翻訳
프랑스대 혁명	フランス革命
분천	間欠泉
비듬	雲脂
붙음	妄想
~의 값을 구하다	批評する
범고래	鯱,さかまた,しゃち,シャチ
비누	石鹸
부질	グルテン
빈대	トコジラミ,南京虫
비데	ビデ
비다	1. 空の 2. 空の 3. 空の
비대	肥大,肥満
야금술	金属工学
반물질	反物質
비름	アマランサス
부탄	ブータン
부탁	願い,依頼,嘆願
비료	肥料
계산상의	計算高い,keisandakai,けいさんだかい,計算可能な
부추	1. 韮,ニラ 2. ねぎ
빼냄	マイナス,引き算,減法
부칭	父称
비밀	ひみつ,秘密,グライバシー
비방	1. ちゅうしょう,中傷 2. ちゅうしょう
비법	きりふだ,切り札
남녀차별	性差別
비번	kyūjitsu,きゅうじつ
분포	分散
침대요	蒲団,ふとん,寝具
빠름	速度
상당한 인물	人,人間
비만	肥大,肥満
문헌학	言語学,文献学
늪지의	浸水した
비명	エピタフ,ひめい,himei
분통	癇癪
공중변소	かわや,手洗い,べんじょ,厠,便所,休憩所,化粧室,憚り,トイレ
진정으로	真剣に,切実に,真面目に
부흥	1. 蘇生,甦生 2. 復活
비새	ケッテイ
비소	ヒ素
빨리	さっさと
북한	北朝鮮,朝鮮民主主義人民共和国
후세인	フセイン
북해	北海
부활	1. 蘇生,甦生 2. 復活
아동학	小児科学,小児科
비비	狒々
로마 교황	教皇,法王,ポープ,ローマ法王,ローマ教皇
빗변	斜辺
액량의 단위	クォート
보충	chōshū,ちょうしゅう,徴集
분배	分配,割り当て
부부재산계약	婚前契約
북미	北米,北アメリカ
본체	実体
프로그래밍	プログラミング,番組
프로그래머	ソフトウェアエンジニア,プログラマー,ソフトウェア開発者
구내 도로	出入用道路
니오브	ニオブ
부문	部門,家族
니오븀	ニオブ
분모	分母
분만	1. 分娩,san,分身,出産 2. 妊娠
분리	1. 離婚,えんきり 2. 論理和 3. 論理和
본토	大陸,内地,本土
분사	分詞
다신론	多神教
보통	いつもは,俗,通常,tada,何時も,一般に,日頃,大抵,普通に,ただ,いつも
부사	副詞
하이퍼링크	ハイパーリンク,超連結子
측미기	マイクロメートル
점잔 빼기	hitogara,ひとがら,人柄
병폐	潰瘍
측미계	マイクロメートル
손 씻는 그릇	洗面器
휴대폰	携帯,けいたいでんわ,携帯電話,セルフォン,ケータイ,セルホーン
부빙	氷山
시에 적합한	詩人の,詩的な
불법	不当,不當
부분	1. 部分 2. 部分
별표	アスタリスク,星印
비계	あしば,足場
너그러운 사람	おうじ,ōji,王子
비골	ひこつ,hikotsu,腓骨
비과	ビワ,枇杷
보통 정도로	いつもは,俗,通常,tada,何時も,一般に,日頃,大抵,普通に,ただ,いつも
야경화	夜想曲
부아	肺,肺臓
볼펜	ボールペン
비가	死者のためのミサ,鎮魂歌
불신	不信心
붕소	硼素,ホウ素
반모음	半母音
비겁	臆病,憶病
불소	フッ素
부식	侵食,腐食,しんしょく,shinshoku
볼트	ボルト
회장석	灰長石,かいちょうせき
부족	1. 不足 2. 飢饉,不足
분점	分点
부종	浮腫,水腫
셀 수 있는	可算
브롬	臭素
부인	1. 奥様,fujin,クイーン 2. 家内,fujin,妻,女子,つま,okusan,奥さん 3. 女
회전등	ランタン,提灯
붕어	鮒,フナ
분재	盆栽
비난	告発,容疑,告訴,ようぎ,言いがかり
건반 악기	鍵盤楽器
부정	不忠実,不信実,不貞
부제	字幕
불어	1. フランス語 2. フランス人
분열	論理和
증대하다	増やす,増す,増加する
불온	発酵
불안	1. 不安,心配 2. 心配
날의사면	斜面
빙하	氷河
시들지않는꽃	アマランサス
막다른 골목	袋小路
비파	ビワ,枇杷
이리자리	紅斑性狼瘡
비품	kagu,かぐ,家具
모닝 코트	アゲハチョウ,agehachō
배타적인 소집단	派閥
미시간	ミシガン
미식가	美食家,料理通,グルメ,食通
다운증후군	ダウン症,ダウン症候群
미소한	ごく僅かの
합성하다	合同
고대 그리스어	古代ギリシャ語
안녕하세요	こんにちは,こんばんは
결혼의 축가	処女膜
동물 기생증	人獣共通感染症,人獣伝染病,動物原性感染症,人獣共通伝染病,じんじゅうきょうつうかんせんしょう,jinjūkyōtsūkansenshō
비용	入費
비유	比喩,修辞,転義法,文彩,言葉のあや,あや
비율	人差し指
비역	こうもんせいこう,アナルセックス
의미가 흐릿한	くもり,(kumori)
비준	ひじゅん,批准,hijun
비중	比重
뺄셈	マイナス,引き算,減法
감금하다	刑務所に入れる,投獄する,けいむしょに入れる
빙원	氷山
비전	深遠な,秘儀の,奥義の,秘密の
민수기	民数記
신성하게하다	恵む
국가적인	国立
비싼	1. 高い 2. 高い
빙산	1. 氷山 2. 氷山
비점수차	乱視
법정 변호사	弁護士
빙실	冷蔵庫
브로츠와프	ヴロツワフ
대벌레	ステッキ,杖,つえ
야금학	金属工学
안드레	アンドリュー,アンデレ,アンドル
본국 송환	そうかん
비취	翡翠,ヒスイ
논리적 타당성	論理学
빵집	ぱんや,panya
모험을 좋아하는	1. 冒険好きな,冒険的な 2. 大胆な
빙점	融点
비축	未処理の仕事
빈차	怠け者
비책	調理手順,レシピ
사워크라우트	ザワークラウト
중국 관화	北京語,華語,国語,北京官話,普通話
카나다	Kanada,加奈陀,カナダ
사구	砂丘
뿔의	むらむら
흥겹게	うれしく,運良く,楽しく,ureshiku
베이지색의	ベージュ
피할 수 없는	必然の,避けがたい
상가	町,都市,街,村
살구	1. サーモン,杏子 2. 杏子
사기	詐欺
산길	ガート
산기	腰痛
꽃잎 장식	フラストレーション,障害物
오랜지주스	オレンジジュース
금리이율	金利,利率
삭감	引き算,減法
방문자	hōkyaku,kyakujin,訪客,きゃくじん,客人
사모바르	サモワール
사과	1. リンゴ,林檎,りんご,林檎の木,リンゴの木 2. リンゴ,林檎 3. リンゴ,林檎,林檎の木,リンゴの木 4. 林檎の木,リンゴの木
사격	斜格
다색의	多色
취사장	調理,料理
미술관	1. 美術館 2. 美術館 3. 画廊,美術館 4. 博物館
양귀비	1. ポピー,ケシ色,ケシ,ヒナゲシ 2. ヒナゲシ
상동	相同性
상도	高速道路,公道,街道,公路,道
새다	にじみ出る
살다	住む
당분해	解糖系
생각	1. 信奉,信仰,宗教,しょしん,かくしん 2. 観念,概念,構想
생계	生活
사당	聖骨箱
사담	サッダーム・フセイン
사단	サタン,魔王
사다	1. 買う,買 2. える,得る,手に入れる,買う,成し遂げる
작은 마귀	エルフ
상공	極楽,パラダイス,楽園,十万億土,rakuen,らくえん,天堂
삐다	挫く
사나	サヌア,Sanua
상기	前述の
백리향	タイム
도량이 넓은	カトリック,カソリック
사치스런	豪華な
번식력이 있는	肥沃な
방목지	放牧地
배멀미	船酔い
쓸쓸한 곳	孤独
미소년	キューピッド
반복의	イテレーティブな
쐐기벌레	皮虫,毛虫,ワーム,芋虫,キャタピラ,無限軌道
어머니의	1. 母方の,母性 2. 母方の,母性
애도가	死者のためのミサ,鎮魂歌
심적 갈등	離岸流,りがんりゅう,riganryū
민사법	大陸法,民法
미생물	1. びせいぶつ,微生物 2. 微生物
짖굳은 장난	悪戯,akugi,あくぎ,いたずら,itazura
배수 분지	流域面積
저명하다	祝われた
축조학	プレートテクトニクス
죄인	罪人
주부	主婦
좡족	チワン族,チワン語
중미	中米,中央アメリカ
좀 습한	湿った
좌천	陥落
중석	タングステン
지각	ishiki,いしき
중세	暗黒時代
지갑	財布,ブリーフケース,札入れ
직각	直角
조합	クラブ,社会
조항	地平線
직경	直径
지고	主権
중수	じゅうすい,重水
종파	宗教
직공	たくみ
이종족 혼교	混血
주소	1. 生息地,棲息地 2. 住居,seki,家屋,せき,住宅,居留
앙갚음	復習
증기	蒸気,湯気,気体
억만장자	億万長者
죽순	竹の子,筍
중상	ちゅうしょう
방광염	膀胱炎
주로	おもに,主に
전화	1. 電話 2. 電話 3. 電話 4. 電話,電話番号
전혀	絶対に
전해	電解,電気分解
전함	戦艦
바꿔침	dainyū,代入,だいにゅう
젖통	ちち
조원	庭いじり
졸업	そつぎょう
바나듐	バナジウム
중단	きゅうし
종양	腫瘍
존재	存在
적합	特徴,適当
적하	つみに,tsumini,積荷
종악	ゴング
중동	近東,中東,ちゅうとう,Chūtō
주민	1. 人民,市民,国民,公民,民衆,臣民,民 2. 隣人,お隣
주방	料理,料理術,台所,割烹
앙골라	アンゴラ
제후	おうじ,ōji,王子
조충	離岸流,りがんりゅう,riganryū
종종	しばしば
정화	浄化
바나나	1. バナナ 2. 芭蕉,バナナ 3. バナナ 4. バナナ
종적	逃げる,nigeru）,失踪する
주말	週末
주막	舎,居酒屋,宿屋
종제	ネーブル,臍
종점	終了
글루타민산	グルタミン酸
군복의 상의	ブラウス
죄수	とりこ,hitoshichi,人質,ひとしち
주문	邪視
담당원	パブリック・リレーションズ,PR,ピー・アール
정황	前後関係,状況,文脈
좡어	チワン族,チワン語
중력	重力,じゅうりょく,万有引力,いんりょく,引力
주택	住居,seki,家屋,せき,住宅,居留
질량	重量,質量
지뢰	地雷
직류	直流,直流電流
지류	小川,流れ,入江,いりうみ,いりえ,入海,川,irie,iriumi
지레	前以て
지령	命令
흔들리다	1. 傾く 2. ononoku,おののく 3. 揺らす,震える,ぶれる,ブラブラさせる,ブラブラする
태반한 행위	油断,過失,yudan,ゆだん
피자식물	被子植物
불가해안 사물	謎,nazo
직복	トーガ
지복	幸い,幸せ
증손	大甥
지붕	屋根
지불	スコットランド人
질문	1. 試験,クイズ 2. 質問 3. 尋問 4. 願い,依頼,嘆願
지배	主権
지방	近所,概算,近傍,近似量
진미	フォアグラ
아제르바이잔어	アゼルバイジャン語
작은 물고기	若者
주판	1. そろばん,頂板,算盤 2. そろばん,算盤
지리	地理学,地理,chiri
배경의	風光明媚
지네	百足,ムカデ
줄자	メートル
주정	エタノール
주제	1. 主題 2. 主題 3. 主題 4. 話題,主題
주절	主文
종형	いとこ,従兄弟,従姉妹
주인	主,持ち主
주의	主義,流派
죽은	亡くなった
주위	辺り,周囲
인도양중의 군도	セーシェル,セイシェル
집게	火箸,パンばさみ
지금	実際に,現在,現在は
중심	じゅうしん
짓다	書く
진디	アブラムシ
진동	1. 震え 2. ononoku,おののく 3. 振戦
중지	休み
중조	重曹
집념	妄想
중죄	犯罪
중이	中耳
변경할수 없는	不可逆な
중위	中尉,副官,少尉
중유	灯油
진앙	震央,震源地
지역	近所,概算,近傍,近似量
지연	先延ばし
직업	1. 仕事,職業 2. 仕事,職業,天職 3. 仕事,職業 4. 仕事,職業 5. 仕事,職業
힌디어	ヒンディー語
질염	膣炎
바께쓰	バケツ
직장	職場
지점	至点
지주	主,持ち主
진주	梨,梨の実
지질	脂質
지진	地震
지지	地理学,地理,chiri
여호와의 증인	エホバの証人
황제 정치주의	スターリニズム,独裁政治,幕府,bakufu,独裁
짝의	姉妹
무직의	失業者,しつぎょうしゃ
지출	入費
일시적인	短命な,はかない,束の間の
주형	雛形
주혈	トキソプラズマ症
질병	疾病,yamai,病気,疾患
주해	アノテーション,注釈
밀의 녹말	デンプン,澱粉
축전지	二次電池,蓄電池
중합	重合
축제일	国民の祝日,祭日,建国記念日,祝日,休日,祝祭日
조롱나무의 일종	万作,mansaku,まんさく
종신 고용	えいせい,常,永世
훌륭한 솜씨	武勇,技量
진사	くれない,朱,あか,緋色,丹朱
지성	叡智
지세	地理学,地理,chiri
이해하다	1. 分かる 2. 分かり切る,了解する 3. 見る 4. 翻訳する 5. 理解する,分かる 6. 分かる,翻訳する 7. 分かる
증언	1. 証言 2. 証言
이시스풍요의 여신	イシス
지상	人相,ninsō,にんそう,顔
대다수	大多数
중화	中和
질소	1. 窒素 2. 窒素
지수	人差し指
증오	1. 憎しみ 2. 存分,憎しみ,憎悪
질색	憎しみ
질산	硝酸
진성	水銀
진심	こんせつ,konsetsu,懇切
(적국에) 협력하다	(敵に) 協力する,共同して働く,協力する
지시	意義,心,意味
지식	心得,chishiki,学識,ちしき,認知,こころえ
지압	指圧
집시	ジプシー,ロマ
짐승	動物
짝패	親友,友,shin'yū,しんゆう
직후	縁起
진화	進化
질환	衰弱
질화	硝化
집행	強制,実施
진흙	1. 泥 2. スライム,ぬめり
엄파이어	レフリー
고수의 잎	コリアンダー
바꾸다	1. 取り換える 2. 替える 3. 通う 4. 変える
쬐다	炙る
식품 첨가물	食品添加物
매니토바 주	マニトバ州
쪽빛	インディゴ
기름기기가 도는	ごますりの
흥미로운	おもしろい,面白い,omoshiroi
집착	接着
지친	故障
진취	きぎょう,企業,kigyō
애국심	愛国主義,愛国心,国家主義
지퍼	ファスナー,ジッパー
성취하다	達成する,収める,成し遂げる
상서로운	1. 運のよい,幸運,運の良い,ラッキー 2. さい先のよい
지학	地球科学
지프	ジープ
동음 이의어	同音異義語,同音語
지표	晴雨計,気圧計
지폐	紙幣
흐리다	不明
노예의 신분	しんじゅう
심부름꾼	ツアーコンダクター,宅配会社,メッセンジャー,旅行添乗員,つかい,運送会社
희금속 원소	プラセオジム
애국자	愛国者
자명한이치	諺,ことわざ,格言
에그노그	アドヴォカート
일종의 리큐르술	シシウド,アンゼリカ
소방펌프	消防車
건강이 좋지 않은	病気
동트는 시각	akegata,暁,夜明け,あけがた,明け方
바닷가	1. 浜,砂浜 2. hama,海辺,沿岸
부자연한 해결책	急場しのぎ,どんでん返し
찰나	国境
참깨	1. ゴマ 2. 胡麻,ゴマ
채광	掘削,開削
창고	1. kura,倉 2. 倉庫,倉
창공	天空,tenkū,てんくう
허튼소리	1. ゴミ 2. 無意味
눈부시게 빛나는	眩しい
싱가포르	1. シンガポール 2. シンガポール 3. シンガポール,新嘉坡
대형 고속 컴퓨터	メインフレーム
약손가락	藥指,薬指
보궐인 명부	順番待ちの名簿
선사시대	先史時代
영국의옛금화	天使,tenshi
저당잡힘	抵当,住宅ローン,抵当権
바닷말	海草
바닷물	かいすい,鹹水,海水,塩水
출입구	ゲートウェー
책방	本屋,書店,ほんや,hon'ya
추악한	酷い,凄い
마르크스	マルクス
오디세이아	オデュッセイア
찬성	拍手
청년	少年,ティーネージャー
배교자	背信者
북미산의 나무	ポーポー
철단	頬紅
차선	規定航路,細道,路地
배고픈	お腹の空いていた,空腹な,飢えた
참새	すずめ,雀
참매	オオタカ
천국	極楽,パラダイス,楽園,十万億土,rakuen,らくえん,天堂
천구	天空,tenkū,てんくう
첨가	にゅうかい,nyūkai,入会
상처받기 쉬움	zeijakusei,ぜいじゃくせい,脆弱性
철금	鉄琴
창립	就職
전핵생물	原核生物
체격	肉,解剖学,人体
체계	tatemono,建物,ビル,家
청구	願い,依頼,嘆願
러더포듐	ラザホージウム,ラザホルジウム
처남	義兄
피겨스케이트	フィギュアスケート
법률화하다	合法化する
참람	おうしゅう,押収,ōshū
차르	ツァーリ,ツァール,ツァー
천거	推薦
천골	仙骨
아니다	いいえ
창녀	売春婦,娼婦,パンスケ,ばいしゅん,させ子,売女,街娼
차드	1. チャド 2. チャド
있음직하지 않게	凄く
천식	喘息
금욕적인	禁欲
신문기수투의 문체	報道,ジャーナリズム
청산	シアン化水素
당뇨병	糖尿病,tōnyōbyō),とうにょうびょう
촛대	燭台
천수	雨,雨水,あまみず,amamizu
척수	脊髄,脊髓
청소	じょうか,掃除
다도해	エーゲ海
이긴 흙	パグ
차차	ようやく,小刻みに
찻집	茶室,喫茶店
근친 상간	近親相姦,インセスト
미성의 가수	サヨナキドリ,小夜鳴鳥,夜鳴き鶯,鶯,ナイチンゲール
책장	本棚
창차	糞袋,腸,大腸,ちょう,腸管,糞嚢
천사	1. 天使 2. 天使,tenshi
결심하다	思い切る
차츰	ようやく,小刻みに
초대	招き,招待,招待状,誘い
백금색	プラチナ,ぷらちな,白金
총끝	銃口
창업	就職
철망	ガーゼ
창연	ビスマス
찬장	todana,とだな,戸棚,食器棚
철리	哲学
차일	日陰,日よけ
참여	参加
천막	日陰,日よけ
청람	インディゴ
헬리포트	ヘリポート
첼로	チェロ
채용	chōshū,ちょうしゅう,徴集
창자	糞袋,腸,大腸,ちょう,腸管,糞嚢
처벌	処罰,制裁,刑罰,罰
총검	銃剣
아대륙	亜大陸
처방	調理手順,レシピ
총각	男の子,あんちゃん
책상	1. 机 2. 机 3. 机,たく
민들레	たんぽぽ
베디스케이프	バチスカーフ
채소	野菜,緑黄色野菜
아니스	アニス
청동	1. 青銅 2. 青銅
찬양	いわい,祝い,iwai
착용	横領,ōryō,おうりょう
차양	日陰,日よけ
전쟁 범죄인	戦犯
치과학	歯科学
아가	男の子,あんちゃん
에스프레소 커피	エスプレッソ
"determinative"	限定詞
전매하다	転売する
셀룰로오스	セルロース,繊維素
겨울 잠자다	冬眠
애가	死者のためのミサ,鎮魂歌
암굴	洞窟
아까	さっき
악기	楽器,樂器,gakki
악귀	1. グール 2. おばけ,へんげ,ゴブリン
사우스캐롤라이나	1. サウスカロライナ 2. サウスカロライナ
안구	眼球
안경	1. 眼鏡,ゴーグル 2. 眼鏡,megane
뉴욕주	1. ニューヨーク州,ニューヨーク市,ニューヨーク,紐育 2. ニューヨーク州,ニューヨーク 3. ニューヨーク州,ニューヨーク
시기 나쁜	ainiku no
안과	眼科学
씹기	咀嚼
채용된 사람	養子
알다	理解する,分かる
야구	野球
약간	多少,少し,こころもち,心持ち
아담	アダム
악대	騸馬
악당	悪党,悪漢,悪人
아니	いいえ
아덴	アデン
광택 있는 청색	トルコ石
앉다	1. 座る 2. 座る 3. 座る 4. 座る
아더	アーサー
안다	立ち込める
아뇨	ううん,いえ
안녕	幸福,福祉
선이 있는	腺状
잘못 부름	誤称,rangnefni
아내	家内,fujin,妻,女子,つま,okusan,奥さん
안뜰	nakaniwa
전문가의	専門的な
알라	アラー,アッラー,アッラーフ
불공평한	不正,不当な
애도	哀悼,悔やみ
아랍	アラビア語
씨름	レスリング
어류학자	魚類学
양곤	ヤンゴン
씨말	牡馬,種馬
아들	1. 息子,坊っちゃん 2. 子,娘,子供
사람의마음을끄는	魅力的
난폭한 사람	穴居人
유흥가의 건달	蜥蜴,トカゲ
전기 쇼크요법	電気けいれん療法
암류	含意
어구	成句,諺,ことわざ
아민	アミン
얼굴	人相,ninsō,にんそう,顔
알몸	素っ裸
암만	アンマン
암말	雌馬,牝馬
아르	アール
남작의 지위	かぞく
씨발	ファックする,セックスする,はめ倒す,セックスをする,寝ると,エッチする,嵌める,性交する
어개	シーフード,魚介類,海産食品,海産物,海鮮
아마	1. 実しやかに 2. 万一,ひょっと,tabun,多分,若しや,まんいち
키르기스스탄	キルギス,キルギスタン
악마	鬼,悪魔,オーガ,akuma,ま,あくま,魔王
약대	アセノスフェア
씨실	ワン
미래파	未来派
여가	1. ひま,暇,hima,余暇,閑散,閑暇 2. 暇,余暇,閑散,閑暇
다리어	ダリー語
여객	乗客
계산적인	計算高い,keisandakai,けいさんだかい,計算可能な
안벽	波止場
아벨	1. アベル 2. アベル
아빠	パパ,父親,お父さん,父上,父,親父
시골 멋쟁이	kare,カレ,カレシ,kareshi,かれし,ボーイフレンド
약방	薬局
양말	1. ストッキング 2. ソックス,靴下
쓰촨	四川省,四川
우편집배인	郵便配達人
열권	熱圏
연금	年金
암소	1. 雌牛 2. 牛,雌牛 3. 雌牛
안식	死者のためのミサ,鎮魂歌
압수	おうしゅう,押収,ōshū
어림짐작	見当
양딱총나무의 열매	ニワトコ
연꽃	蓮,ロータス
영공	空間
예감	予感
중등 학교	中学校
단말기	端末
예견	予知
영국	連合王国,グレートブリテン島,ブリテン,英国,グレートブリテンおよび北アイルランド連合王国,イギリス
영구	えいせい,常,永世
앞서	予め,あらかじめ
앨범	arubamu,アルバム
여격	与格
아삼	アッサム州
언니	姉妹
연결	結合
연계	性交
여과	濾過
얻다	1. える,得る,手に入れる,買う,成し遂げる 2. 得る 3. 達成する,収める,成し遂げる 4. える,得る,勝利する
여관	1. 舎,居酒屋,宿屋 2. ホテル,旅館
약물	薬理学,薬学
밀라노	ミラノ
연골	軟骨
연고	軟膏
여권	パスポート
작열하는 곳	kama,炉,karo,火炉,かろ
암살	暗殺
악수	あくしゅ,akushu,握手
여급	ウエーター,ウェイトレス,ウェートレス,ウエイトレス
안와	軌道
어른	大人
어림	かしょうひょうか,過小評価
어망	魚網
악의	がいしん
암양	羊,牝羊, 雌羊
얼른	さっさと,早々
역도	重量挙げ,ウエイトリフティング
암실	暗室
다리미	アイロン
영기	エクトプラズム
씨족	家族
아양	軟派
여녜	興,娯楽
악어	鰐,わに,wani,ワニ
아연	亜鉛
백내장	瀑布,激流,白内障
아예	marude,全く,まるで,全て,丸で
어뢰	魚雷
양봉	養蜂
언론	1. 報道,ジャーナリズム 2. 報道
반대말	対義語,反対語,対語,反意語,反義語
야심	野心,抱負,アンビション
압정	画鋲
애욕	性衝動,リビドー
양산	傘,かさ,kasa,パラソル
오기	rakugaki
엔트로피	エントロピー
엄마	1. 母,母親,お母さん,おふくろ,母上 2. 母,お母さん,ママ
암장	マグマ
아가씨	少女,女の子
알제	アルジェ
아주	marude,全く,まるで,全て,丸で
양심	良心
약어	省略語
더구나	1. -も,また,も,さらに,にも 2. その上,しかも,その上に,尚且つ,さらに,katsu
당략의	政治上の,政治的な
애정	1. 愛着 2. 愛情,愛,aijō
어븀	エルビウム
애인	kare,カレ,カレシ,kareshi,かれし,ボーイフレンド
완강	忍耐,堅持
어부	漁師
엘베	エルベ川
염력	観念動力,サイコキネスシス,念力,念動力,テレキネシス
약자	省略語
야인	ネアンデルタール人
오다	1. 来る 2. 来る 3. 来る 4. 着く,到着する 5. 来る 6. 来る
악취	悪臭,臭い
여름	夏時,なつ,natsu,夏期,夏,夏時間
연루	共謀,共犯
오늘	ほんじつ,きょう,honjitsu
연료	プログラム,ソフト,ソフトウェア,ソフトウエア
야웅	ニャア,にゃ
어떻게든지	なぜか
야옹	ニャア,にゃ
소시지형 계류기구	腸詰め,ソーセージ
여론	世論
영리	器用さ
약지	藥指,薬指
올된	1. soujuku,早熟,そうじゅく 2. soujuku,早熟,そうじゅく
액체	1. 液体 2. 流体,液体 3. 液体
영률	ヤング率
알켄	アルケン
얘야	男の子,あんちゃん
어순	語順
억수	大雨,土砂降り
수수께끼같은	神秘的
약종	薬剤師
압축	狭窄
언설	発話
온도	気温,おんど,温度,ondo,熱
약제	薬物,薬
염료	染料
우뢰 소리	雷鳴,迅雷
어선	漁船
어서	さっさと,早々
연보	ニュースレター,かいし,kaishi,会誌
애칭	愛称
아톰	原子,元素
달라이라마	1. ラマ 2. ダライ・ラマ
외계	宇宙空間,惑星間宇宙
에서	エサウ
예멘	イエメン共和国,イエメン
영묘	廟,霊廟
왕녀	ひめ,ōjo,姫,王女,hime,おうじょ,王妃
외과	外科
예명	筆名,雅号,ペンネーム
에센	エッセン
오락	1. スポーツ 2. 興,娯楽
연민	慈悲
아탄	亜炭,褐炭
얕은	浅薄,あさい,浅い
역병	梅毒
알킨	asechiren,アセチレン,アルキン
엄수	忠実度
교황의 지위	司教の職
아편	アヘン,阿片
언어	言語
크로코다일	鰐,わに,wani,ワニ
어원	ごげん,gogen,語源
흑룡강	アムール川
예법	作法
오류	誤謬
야채	野菜,緑黄色野菜
완두	1. エンドウ 2. エンドウ 3. エンドウ,豌豆,エンドウ豆
오로	悪露
요구	嘆願
예비	未処理の仕事
다림줄	すいじゅん
얼음	霜,氷
언쟁	混乱
악행	茶目
오물	スライム,ぬめり
연소	フロギストン
아호	筆名,雅号,ペンネーム
욕구	食欲
아가리	孔,開口部,くち
아픔	痛み,苦痛,itami
아픈	病気
어의	意義,心,意味
오만	オマーン
오리	アヒル,カモ,かも
요가	ヨガ,ヨーガ
여성	1. 女 2. 家内,fujin,妻,女子,つま,okusan,奥さん
역설	逆説,矛盾
악한	悪党,悪漢,悪人
악필	rakugaki
어장	漁業,水産
여생	来世
염소	ヤギ,山羊,やぎ
얄타	ヤルタ
예산	予算
에이	エー
에일	ビール,エール
영속	永世
암호	暗号化
양충	スナノミ
염산	1. 塩酸 2. 塩酸
절망적인	絶望的
여신	1. 神性 2. めがみ,megami,女神
역시	-も,また,も,さらに,にも
엄지	親指
오븐	レンジ,オーブン,ストーブ
예속	しんじゅう
용기	1. 勇気 2. いれもの,iremono,入物,入れ物,コンテナ,容器 3. 男気,勇気 4. 度胸,勇気,きも
우기	雨季,雨期
연어	1. サーモン 2. サーモン
액화	液化
예수	イエス・キリスト,みこ,イエスキリスト,キリスト
여어	こんにちは,今日は
여윈	やつれた
약품	薬物,薬
연역	三段論法
여왕	1. 女王 2. 女王バチ
전매회사	専売,独占
양파	1. 玉ねぎ,たまねぎ 2. 玉ねぎ,たまねぎ 3. 玉ねぎ,たまねぎ,玉葱
약학	1. 薬学,薬局 2. 薬理学,薬学
영어	イングランド人
게일족의	ゲール語,ゲール族
영양	羚羊,カモシカ,レイヨウ
요도	尿道
여제	女帝,皇后,妃
여접	余接,コタンジェント
여응	興,娯楽
야한	どぎつい,あくどい,けばけばしい,派手な
연음	フェルマータ
여자	1. 少女,女児,女の子 2. 女 3. 家内,fujin,妻,女子,つま,okusan,奥さん
어치	ジェイ
예언	予言
월경	1. 時代 2. 時代
바둑곰	パンダ
여주	茘枝,レイシ,ライチ
옥수	玉髄
원광	後光
친절한 대접	おもてなし,持て成し,款待,集客,ホスピタリティー,厚情
영예	賛美,万丈
엷은	水っぽい
라디오 방송국	ラジオ放送局
오손	片輪
원고	原告
영역	領域
온실	1. 温室 2. おんしつ,温室,onshitsu
영장	令状
연지	頬紅
밤놀이	夜遊び
반대어	対義語,反対語,対語,反意語,反義語
오식	誤植,タイプミス,誤字
원기	エネルギー
영원	井守,イモリ
야훼	ヤハウェ,エホバ
악성 흑색종	メラノーマ
영존	永世
형형색색으로	色々
예의	いつもの,tada,ただ
의아스러움	疑い
반대자	aite,相手
울다	1. 歌う 2. 歌う 3. 叫ぶ 4. 歌う
어리석게도	へらへら
염증	外反母趾
양흥	グレナデン・シロップ
엉킨	不可解な
오염	1. 汚染 2. 汚染 3. 汚染 4. 汚染
웃다	笑う,笑い飛ばす,一笑に付す
울두	アイロン
에탄	エタン
오월	五月,5月,ごがつ
요리	調理,料理
오이	1. 胡瓜,きゅうり 2. きゅうり
요망	願い,依頼,嘆願
욕망	食欲
오자	誤植,タイプミス,誤字
온유	比喩,比諭,hiyu,隠喩,ひゆ,象徴
왕수	王水,おうすい
취리히	チューリッヒ
오존	おぞん,ozon,オゾン
우란	ウラン
엽초	ぼぼ,膣,つび,へへ,そそ
우력	トルク,toruku
오줌	1. ピー,尿,おしっこ,小便 2. 尿,小便 3. 小便をする,おしっこをする
어휘	用語集
거시 경제학	巨視的経済学,マクロ経済学
유가	ヨガ,ヨーガ
여태	これまでのところ,これまで,今まで
와이	ワイ
용모	人相,ninsō,にんそう,顔
예측	縁起
요부	妖婦,妖女,ファム・ファタル
운명	カルマ
와좌	王位,王座,おうざ
육교	ガード
완전	一切
원래	本来
오찬	昼食
우편 집배원	郵便配達人
윈난	雲南,雲南省
운모	雲母
왼손잡이 투수	サウスポー
발효 사과술	シードル
용법	学術用語,術語,専門語,命名法
운문	詩,韻文,かがく,詩歌
열파	熱波
온천	温泉
우박	雹,霰,ひょう,あられ
정신병학	精神病学
대동사	諺,ことわざ,格言
보호하다	飼う,食べさせる
용암	溶岩
오해	過ち,間違い,誤り,錯誤
용액	トルコ石
요염	軟派
융단	カーペット,絨毯
외질	エクトプラズム
음낭	陰嚢
운석	隕石
요약	概要,要約
오팔	オパール
저해하는	不可解な
대도시	リンゴ,林檎,りんご,林檎の木,リンゴの木
월보	ニュースレター,かいし,kaishi,会誌
외전	外向性
유도	jūdō,柔道
음경	陰核,ペニス,ちんこ,ちんちん,陰茎,男根,ちんぽ,イチモツ
욕심	強欲
용사	戦士,せんし
오탁	汚染
영향	作用,影響
수동식 오르간	ハーディ・ガーディ
유대	ゆだや
유당	乳糖,ラクトース
쓰레기	残留廃棄物,ゴミ
총톤수	トン数
요술	1. 魔術,魔法,呪術 2. 手品,魔術 3. 黒魔術,呪術 4. 手品
심근경색	心筋梗塞
안경상	眼鏡屋
윤년	閏年
연필	鉛筆,えんぴつ
설명할 수 없는	説明できない
은거	ていねんたいしょく
역학	力学
열풍	シムーン
여행	1. 旅行,旅 2. 旅 3. ハイキング 4. ツアー,旅行,旅,たび
여할	コセカント
윽교	ガード,高架橋
윈도	Windows,ウィンドウズ
헬리콥타	1. ヘリコプター 2. ヘリコプター
여현	余弦,コサイン
연합	同盟
원료	原料
원리	主義,流派
왕좌	王位,王座,おうざ
왕족	ひめ,ōjo,姫,王女,hime,おうじょ,王妃
왕조	王朝
요새	1. 要塞 2. 城塞
다락방	屋根裏部屋
연풍	微風
재귀	再帰
인두	咽頭
음료	飲料,いんりょう,飲み物
읽다	1. 読む 2. 読む 3. 理解する,分かる 4. 読む 5. 読む 6. 読む
인도	舗装,舗道,歩道
장군	大将
재결	裁決
위선	不誠実
잠깐	しばらく
대동맥	大動脈
원자	原子,元素
이도	イド語
대담한	1. 大胆な 2. 大胆な
재강	酒粕
자꾸	1. いつも 2. 連続的に 3. しばしば
원유	石油,灯油,原油
재가	ひじゅん,批准,hijun
음란	失禁
유별	分類
유방	おっぱい,乳房,胸
원예	庭いじり
원앙	オシドリ
자기	磁器,ポースレン,陶磁,焼き物,陶磁器
잉꼬	1. 脊黄青鸚哥 2. 脊黄青鸚哥
유문	幽門
자궁	子宮
욕창	褥瘡
우정	友情,友好,仲良し
이끼	コケ,苔
자계	磁場,磁界
임기	司教の職
옹호	擁護,立証
방담회	話々,世間話
우유	1. 乳 2. ミルク,牛乳,乳 3. 乳
작가	著者,作者,さくしゃ
자객	ちんぴら
용접	溶接
입국	nyūshoku,いにゅう,にゅうしょく,入植,イミグレーション,移民
월식	gesshoku,月食,げっしょく,月蝕
입구	ドア,戸,門,扉
위법	違法,違法性
용재	スラグ,鉱滓
인기	人望,にんき,じんぼう,ninki,jinbō
위반	侵害
완패	じょうか,掃除
유로	ユーロ
대단히	極めて
인권	人権
일광	日光,nikkō,にっこう,光,太陽光,たいようこう
유령	1. 妖精,仙女 2. ばけもの 3. お化け
우엉	牛蒡
우어	呉方言,ウー,呉語,吳
인구	住民
유럽	欧羅巴,ヨーロッパ,欧州
원소	微量元素
우아	優雅さ
유람	観光
와트	ワット
욕조	浴槽
인계	乗っ取り,謀叛
이교	ペイガニズム
거드럭거리는	小刻みな
기분좋게	心地よく
일가	いとこ,従兄弟,従姉妹
요정	妖精,仙女
위조	偽作,偽物
우파	ウファ
육안	肉眼
유아	小児,赤ちゃん,赤ん坊
유역	流域面積
유엔	EU,ヨーロッパ連合,欧州連合
일몰	日没
이민	移住者,移民
우편	ゆうびん,郵便
이미	もはや,とっくに,最早,既に
위증	偽証の罪
음색	音色
이발	刈り込み,理髪,ヘアカット,髪型
일문	家族
자료	データ
이별	バイバイ,さようなら,では,またね,じゃ、また,バイ,おねんね
우표	切手
유월	六月,ろくがつ,水無月,6月
재능	1. 才能 2. 手腕 3. 手腕,能力
의복	1. 衣装,衣類,ifuku,いふく 2. 衣服,服,衣類,fuku 3. 衣装 4. 衣装
이름	1. 名前 2. みょうじ,苗字,姓氏,あだ名,名字,姓 3. 仮名,あだ名,源氏名,かな,假名 4. あだ名,名前,固有名詞 5. タイトル,名前,標題 6. 名前
임신 기간	妊娠,にんしん
잠두	空豆
다랑어	1. マグロ,鮪 2. マグロ,鮪
이마	額,おでこ
인류	1. じんるい,人類,jinrui,人間 2. 人類,人間
의분	ふんまん
잠든	眠っている,寝ている,しびれる
요항	地平線
인망	人望,にんき,じんぼう,ninki,jinbō
일률	画一性,統一性,普遍性
은사	恩赦,許し
익명	筆名,雅号,ペンネーム
이모	おば,小母さん,おばさん
화폐학	貨幣学
유성	1. 流星 2. 流星,流れ星
악마 숭배	サタニズム
위액	胃液
의문	質問
요트	1. ボート,船,ゆうらんせん,ヨット 2. 帆船,はんせん
이란	イラン,イラン・イスラム共和国
재난	事故
이력	教科
장님	盲目
인력	重力,じゅうりょく,万有引力,いんりょく,引力
잘된	幸運な,成功した,成功裏の
의미	意義,心,意味
잡담	話々,世間話
위염	いえん,胃炎
인듐	1. タリウム,インジウム 2. インジウム
입다	kasumi
의례	儀式
이득	戦利品,略奪品
입대	nyūdan,入団,にゅうだん,登録
아그라	アーグラ
입덧	悪阻
잡낭	バックパック
의류	衣装
다람쥐	木鼠,栗鼠
유생	幼虫,幼生
외피	皮膚
음문	いんもん,inmon,陰門
때때로의	時折の,偶発的,偶然な,偶,時折
자당	スクロース
후원자	スポンサー
유사	アナロジー,類推
유산	堕胎,流産,失敗
요통	腰痛
장난	お祭り騒ぎ
유충	幼虫,幼生
흔들이	振り子
의원	議員
유추	アナロジー,類推
일식	日食
저능	頓痴気,低能者,間抜け,baka
위턱	上顎,口蓋
읍장	市長
음절	音節
자석	1. 磁気 2. 磁気 3. 磁石,じしゃく,jishaku
임신	1. 妊娠 2. 妊娠,にんしん 3. 妊娠
적도	1. 赤道 2. 赤道
의제	架空,小説
자세	1. 見得,姿勢 2. 見得
자산	資産
적대	ライバル
적당	tekisetsu,てきせつ
어리치다	ぶきみな
의의	意義,心,意味
저당	hitoshichi,人質,ひとしち
잇속	いれば,入歯,ireba,総義歯
잿물	苛性アルカリ溶液
의장	議長,委員長,主席
자생	自然発生説
작살	1. ハープーン 2. やす,銛
의자	ソファ,ソファー,長椅子
자살	自殺
아랍에미리트 연합	アラブ首長国連邦
큰 시련	はりつけ
정금	硬貨
인성	じんしん,人心,jinshin
쟁론	論争
자부	自惚,己惚
음역	翻字
인사	挨拶
은자	1. 仙人,世捨て人 2. 世捨て人 3. 世捨て人
인삼	オタネニンジン
제금	1. シンバル 2. カスタネット,シンバル
키시뇨프	キシナウ,キシニョフ
전념	忠誠
장미	bara,ばら,薔薇,バラ
인소	リン,燐
저녁	1. 夜 2. 夜 3. gogo,午後,夜,ごご
인쇄	タイポグラフィ
원형	元型
유진	ユージン
육지	1. 大陸 2. Riku,陸,海岸
아디스아바바	アディスアベバ,アジスアベバ
유지	保持,保存
자백	断言
울화	癇癪
정감	痛切
의심	万一,ひょっと,tabun,多分,若しや,まんいち
장르	属,ジャンル,janru
은어	方言
잘못	1. 誤植,タイプミス,誤字 2. 文法違反 3. 過ち,間違い,誤り,錯誤 4. そつ
고도 과학 기술	ハイテク
전구	電球
전국	醤油,醬油,しょうゆ,shōyu
은유	1. 比喩,比諭,hiyu,隠喩,ひゆ,象徴 2. 比喩,修辞,転義法,文彩,言葉のあや,あや
위치	連語
제거	除去
이사	上院議員
장모	義母,姑
정관	精管
음악	1. 音楽 2. 音楽 3. 音楽
미망인	未亡人,後家
우한	武漢,武漢市
적격	合格
의성	擬音語,ぎおんご,擬声,オノマトペ,擬声語,擬声擬態語,擬音
유입	ryūnyū,りゅうにゅう,流入
공중누각	空想
유장	1. 乳清 2. 乳清 3. 乳清
임무	1. 宿題,任務 2. 任務 3. 企業,任務 4. 任務 5. 雑用,任務,雑務 6. 任務 7. 宿題
자립	どくりつ,独立
자막	字幕
자만	自惚,己惚
과대 평가하다	過大評価する
자매	姉妹
의사	医者,医師
입법	法規
우화	アレゴリー,寓言,ぐうげん
전공	専門
전광	電球
장례	1. 葬式,葬儀 2. 葬式
전계	電場,電界
일본	1. 日本 2. 日本
응수	返答,回答
이브	イヴ,イブ
큰 사슴	ヘラジカ
인지	心得,chishiki,学識,ちしき,認知,こころえ
저류	含意
일지	天体暦
작은	ちょっと
전류	1. 電流 2. 電気 3. 電気,電流
조개	ムラサキ貝,イガイ,ムール貝
자유	1. 自由 2. 自由 3. 自由
조가	死者のためのミサ,鎮魂歌
조각	彫刻
유품	土産
유풍	遺物,聖遺物
자위	自慰,オナニー,マスターベーション,オナニ
자역	字訳
제드	ゼッド,ゼドゥ
키시너우	キシナウ,キシニョフ
작약	ぼたん,牡丹
일전	ペニー
전화 번호	電話,電話番号
이질	赤痢
전력	電力
자엽	双葉
전면	建前,ファサード
유혈	大虐殺
조국	ぼこく,bokoku,ほんごく,母国,本国,hongoku,祖国
잘자	おやすみなさい
전멸	壊滅
전문	専門
장원	荘園
자주	時々,時時,ときどき,tokidoki
안과학	眼科学
장액	乳清
장애	1. 障害物 2. 障害物 3. 障害物
전말	先史時代
의치	いれば,入歯,ireba,総義歯
쟁송	論争
자장	磁場,磁界
작인	因果関係
장어	1. ウナギ,鰻 2. ウナギ,鰻 3. ウナギ,鰻
정력	エネルギー
절망	必死
비뇨기과 전문의사	泌尿器科医
임질	淋病
존경	畏敬
출생지	出生地
시계 제조인	oro-rojisu-tu,時計屋
자정	真夜中,yonaka,よなか,しんや,深夜
접다	立ち込める
이온	イオン
인어	人魚,ningyo,にんぎょ
잡석	ゴミ
유타	ユタ州,ユタ
전등	電球
젖니	乳歯
작시	詩,韻文,かがく,詩歌
인연	カルマ
장색	たくみ
이월	二月,如月,にがつ,2月
일언	音節
점도	粘度
예루살렘	エルサレム,イェルサレム
자손	1. 子孫 2. しそん,御曹司,子孫,こういん,shison,後胤,接ぎ穂 3. 後人 4. 子,娘,子供 5. 子種,子孫
응집	凝集
솔직히 말하면	正直に
제논	キセノン
이어	連続的に
소리의 요정	ポルターガイスト現象
절도	盗み
위해	茶目
이점	得,やく,便宜,優位,有利
이접	論理和
잠시	しばらく
반드시	決まって,かならず,renjitsuren'ya,連日連夜
재속	世俗の,世俗,非宗教的な,非宗教的,世俗的な
저락	堕落,daraku,だらく
이유	何故,どうして
제니	ジン,精霊
인용	引用文,引用
이음	異音
제다	ジッダ
제대	臍の緒,臍帯
재산	資産
이인	異人,外人,外国人,がいこくじん
장소	遺伝子座
임업	林業
일월	いちがつ,1月,睦月,一月
의혹	疑い
전선	1. 前線 2. 前線
졸다	居眠り,いねむり
적성	手腕
일터	ぶどう園,ブドウ園
전사	戦士,せんし
큰 상점	デパート
응혈	痛風
쟁점	論争
정부	情婦
반들반들한	パイパン
정서	感情
정상	頂点
저승	来世
의회	元老院
작은 상자	カセット
암갈색	暗赤色
전보	電報
종교	宗教
정물	パブ,静物画
정문	泉門
절벽	1. 断崖,絶壁 2. 崖
잡종	混血
절반	官能基
좋게	心地よく
아이오딘	1. ヨードチンキ,ヨウ素 2. ヨウ素
재의	青ざめた
달래다	なだめる
인천	仁川広域市
자지	陰核,ペニス,ちんこ,ちんちん,陰茎,男根,ちんぽ,イチモツ
정리	定理
정보	情報
젖병	1. 哺乳びん,びん,哺乳瓶,瓶,ビン 2. 哺乳びん,哺乳瓶
쉽사리 알수 있음	あきらか
대들보	1. hari 2. 梁
재즈	1. ジャズ 2. ジャズ
뼈만 앙상한	やつれた
자책	良心の呵責,改寤,悔悟
음편	音楽
전분	デンプン,澱粉
조끼	ウェストコート
은하	1. 星雲,銀河 2. 天の川,天の川銀河,銀河
잡지	1. 雑誌 2. 雑誌 3. 雑誌
은행	1. 銀行 2. 銀行 3. 銀行
종기	膿瘍
아구티	アグーチ
일치	1. 協心,コンセンサス,合意,総意 2. 合意
전쟁	1. レスリング,戦争 2. 戦争 3. 会戦,ikusa,レスリング,戦い 4. 戦争 5. 戦争
조모	祖母,お婆さん,そぼ,外祖母,おばあさん
졸린	nemui,ねむい,眠い,眠
배당금	被除数
적절	tekisetsu,てきせつ
승리의 여신	しょうり,kachi,勝利,勝ち,ゆうしょう
정액	精子,精液
전이	転移 (医学)
암흑 시대	暗黒時代
전자	1. 電子 2. 電子
점원	店員
정온	安穏,安寧,あんねい
정오	正午,jūni-ji,昼,真昼,しょうご,shōgo,十二時,じゅうにじ
제안	提案,申入
자황	雌黄色,雌黄
작은 수로	おがわ
젊은	若々しい
적조	赤潮
전조	縁起
저주	アナテマ
전좌	翻字
정유	精油
종마	牡馬,種馬
종류	1. 部門,家族 2. 属 3. 部門,しゅるい
점자	1. ブライユ点字 2. 盲文
전징	徴候,前駆症状
점점	ようやく,小刻みに
제이	ジェイ
정점	頂点
평론잡지기자	レフリー
족보	家系図
제유	提喩,提喩法
휘발성의	発破,揮発性
조부	外祖父,祖父,そふ,お爺さん,おじいさん,sofu
화학식	化学式
제자	弟子
주거	住居,seki,家屋,せき,住宅,居留
접지	しそん,御曹司,子孫,こういん,shison,後胤,接ぎ穂
주교	1. 司教 2. 教皇,法王,ポープ,ローマ法王,ローマ教皇
주괴	地金,インゴット
점질	粘度
접수	乗っ取り,謀叛
이해	理解
일품	梨,梨の実
죄과	短所,デメリット
점심	1. 昼食 2. asameshi,朝飯,朝食,昼食,あさめし,朝御飯 3. 昼食
이혼	離婚,えんきり
제수	除数
자판	キーボード
인형	ningyō,にんぎょう,人形
조력	じょせい,援助,助け,tasuke,たすけ,補助
전압	デシベル
이후	今後,今や,これ以後
전액	一切
임학	林業
일화	逸話,秘史
전에	1. 以前に,以前 2. 旧来,かつて
제시	展覧会
장터	1. 市場 2. 市場
입학	入校,にゅうがく,nyūkō,nyūgaku,入学,にゅうこう
전연	綺麗に
전역	全域
적운	積雲
저울	1. 天秤,秤 2. 天秤,秤
적요	1. 概要,要約 2. 剥奪,凝縮,要約
아이올리	アイオリソース
작풍	様式
점액	スライム,ぬめり
적임	合格
족말	デンプン,澱粉
적자	赤字
중개업자	不動産屋
육상 경기	1. スポーツ 2. 運動競技 3. 運動競技
정치	政府
정충	精子,精液
화합물	1. 化合物 2. 化合物
주다	1. 払う 2. あげる
비트는 힘	トルク,toruku
중뇌	中脳
전투	1. レスリング,戦闘 2. レスリング,戦争
중년	中年
전통	1. 伝統,でんしょう,伝承,でんとう 2. 伝統,でんとう 3. 伝統,でんとう 4. 伝統,でんとう
죄명	告発,容疑,告訴,ようぎ,言いがかり
안길라	アンギラ
정탑	灯籠,ランタン,提灯
조약	条約
핀란드어	フィンランド語
후자의	後者
종별	分類
주요 용어집	用語集
줄곧	絶え間なく,いつも
제도용 핀	画鋲
좀비	1. ゾンビ 2. ゾンビ 3. ゾンビ
잠이 깨다	目を覚ます,起こす,目覚める,目ざめさせる,起きる
중국	中華人民共和国,中国
조선	1. 朝鮮 2. 北朝鮮,朝鮮民主主義人民共和国
정찬	昼食
중공	中華人民共和国,中国
점차	ようやく,小刻みに
조상	1. 親 2. そせん,先祖,sosen,祖先,senzo,せんぞ
조사	1. 調査,研究 2. 調査,研究 3. 検討,調査,研究
과일주스	フルーツジュース,果汁
단량체	モノマー
정체	麻痺,まひ状態
중기	中期
세로의 가장자리	蛭,ヒル
당파	秘密結社,カルト
덧옷	うわぎ,上着,uwagi
던전	1. ダンジョン 2. ダンジョン 3. けいむしょ,ペナルティーキック,かんごく,刑務所,監獄,ダンジョン
달필	1. 文字,書道 2. にゅうぼく,書道,筆,カリグラフィー,書法,nyūboku,入木
극단적인	過度,過度の
동란	発酵
도마	跳び箱
독립	どくりつ,独立
명성을얻다	着く,到着する
습지가 있는	浸水した
대화	1. 会話 2. 会話 3. 話し,カンバセーション,談話,かいわ,会話,話,対話
성기고 얇은 천	ガーゼ
베릴륨	ベリリウム
돛배	帆船
주기율표	周期表
독부	イゼベル
대하	ロブスター,イセエビ
대학	大学
대항	ライバル
동물	動物
동무	友達,友人
대포	武器,大砲
의붓 아들	継息子,継子
동맥	1. 動脈 2. 動脈 3. 腺
도벽	窃盗症
담화	1. 会話 2. 話し,カンバセーション,談話,かいわ,会話,話,対話
두개	頭蓋骨
동료	1. 同僚 2. 配偶者,夫 3. 親友,友,shin'yū,しんゆう
돌멘	支石墓
도박	kake
도심	じゅうしん
두뇌	頭蓋骨,頭骨,髑髏,骨
도식	グラフ
돌솜	アスベスト,石綿
포루투갈의 수도	リスボン
독소	毒素,毒
미친것	精神異常
수도원장	掌院,僧正
유리 공장	硝子
돌연	ふと
두등	不同,不平等
독어	ドイツ人,独語,ドイツ語
둔덕	砂丘
애써 공들인	真面目
두다	置く
동사	1. 動詞 2. 動詞
당쇄	1. オリゴ糖 2. オリゴ糖
마리네드	マリネード,マリネ
댄서	舞踊家,踊り子,ダンサー
대수	対数
당신	いとしい,itoshii
쇠고기 햄버거	ハンバーガー
단언	断言
다예	万芸,bangei,ばんげい
답사	偵察
늪지	苦境,窮地
뉴턴	ニュートン
버스)	リムジン
담수	淡水
도교	1. 道教 2. 道教 3. 道教
닭장	鶏舎
도구	道具
단점	終了
대양	大洋,外海,海洋,海
닳은	疲れる
더반	ダーバン
돌궐	トルコ人,トルコ語
대용	dainyū,代入,だいにゅう
가장정치	家父長制
다윈	ダーウィン
천문력	天体暦
독감	流行性感冒,ryūkōseikanbō,りゅうこうせいかんぼう,infuruenza,インフルエンザ
다인	ダイン
다재	万芸,bangei,ばんげい
독거	孤独
단작	モノカルチャー
단체	大學,学園,大学,学寮,単科大学
덤불	雑木林
관료주의	官僚制
유리 그릇	硝子
류블랴나	リュブリャナ
단축	剥奪,凝縮,要約
도당	派閥
덴버	デンバー
버밍엄	1. バーミンガム 2. バーミンガム
自動車	乗用車,車,四輪車,kuruma,自動車,くるま
동굴	洞窟
덴막	デンマーク,丁抹
대입	dainyū,代入,だいにゅう
대유	提喩,提喩法
동경	憧れ,akogare,あこがれ
도넛	ドーナツ
대조	対比,比較
데몬	魔王
니켈	1. ニッケル 2. ニッケル
델리	デリー
도끼	1. 斧,アックス 2. トマホーク
대접	興,娯楽
함수탄소	炭水化物
이제 까지	これまでのところ,これまで,今まで
대충	ぐらい,先ず,およそ,約
다툼	争い
동독	東ドイツ,ドイツ民主共和国
디아스포라	四散,ディアスポラ
도도	ドードー
동녁	akegata,暁,夜明け,あけがた,明け方
다카	ダッカ
도덕	倫理,倫理学
기다리는 시간	待つこと
돕다	1. 手伝う 2. 手伝う 3. 手伝う 4. 手伝う
도둑	1. hito,ひと 2. 泥棒
단당	大佐
가축 상인	羊飼い
단독	丹毒
다능	万芸,bangei,ばんげい
담낭	胆嚢
닥다	1. 磨く 2. 磨く 3. 磨く
닦다	磨く
에콰토르	エクアドル
창조론	創造論
대두	大豆,だいず,ダイズ,daizu
다래	キウイフルーツ,キーウィフルーツ,キーウィ
다롄	大連
다렌	大連
단락	段落
골파의 잎	チャイブ
대답	返事
담력	度胸,勇気,きも
다만	やはり,しかも,それにもかかわらず,それでも
달력	1. カレンダー 2. カレンダー 3. カレンダー
달러	人民元
뉴욕	ニューヨーク州,ニューヨーク市,ニューヨーク,紐育
근처의 주요도시	町,都市,街,村
당류	炭水化物
다방	1. 茶室,喫茶店 2. kafe,コーヒーハウス,珈琲,コーヒー店,喫茶店,カフェ
다발	束,層
축구 선수	アメリカンフットボール,サッカー,アメフト
미카일	ミカエル,マイケル
대령	大佐
티베트어	チベット語
북미 토인의 신발	モカシン
상류지역	川上
대모	1. 教父母,教母,名付け親,教父,代父母 2. 教母,代母
담배	1. たばこ,シガー,葉巻 2. タバコ,たばこ,紙巻き煙草,煙草 3. たばこ 4. 雑草 5. タバコ 6. タバコ
외바퀴 손수레	手押し車
덮개	衣装,衣類,ifuku,いふく
대망	野心,抱負,アンビション
대마	1. マリワナ,インド大麻,大麻 2. 麻
대만	1. 臺灣,たいわん 2. 中華民国,中國,台湾
대류	対流
니스	ニース
담보	保証
답변	返事
당밀	1. 糖蜜 2. 糖蜜
능직	絢緞子
다수	群衆
닭살	鳥肌
알락해오라기	さんかのごい
대부	1. 貸付け,ローン 2. スポンサー 3. 教父母,教母,名付け親,教父,代父母
급속냉동	フリーザー
더욱 나쁜	さらに。。。悪い,もっと悪い,いっそう悪い,より悪い
뇌염	脳炎
인칭대명사	人称代名詞
뇌우	らいう,雷雨
녹턴	夜想曲
영지주의	グノーシス主義
안드로겐	アンドロゲン,男性ホルモン
두샨베	ドゥシャンベ
노포	カタパルト
안개짙은	kasumi
눈썹	眉,眉毛,まゆ,まゆ毛
늘다	1. 増す,上げる 2. 増やす,増す,増加する 3. 増す 4. 足す
관료정치	官僚制
사탕무우 뿌리	ビートの根
누에	カイコ
눈알	眼球
단결	結束,連帯
파충류학자	爬虫類学者
천문학	天文学,天文,天文學
누이	姉妹
십이지장	十二指腸
작은 시내	おがわ
저체온증	低体温症
대결	対決
당구	ビリヤード
말 못 하는	黙々
느린	のそのそ,そろそろ
대개	1. おもに,主に 2. 多く,一応 3. いつもは,俗,通常,tada,何時も,一般に,日頃,大抵,普通に,ただ,いつも 4. 一応,主に,大概
대군	連隊
당근	ニンジン
가장자리	国境
방정식	1. 方程式 2. 方程式
눕다	臥す,俯せる,身を伏せる
그물버섯	網笠茸,アミガサダケ
화학요법	化学療法
뇌물	脂肪
리투아니아	リトアニア
어구의 축어역	翻訳借用
노아	ノア
도넛형의 굳은 빵	ベーゲル
산스크리트어	サンスクリット,梵語
술을 많이 마시는	酔っ払う,酔っ払い,酔う,酔い
지옥같은 광경	火災,大火,火,大火災
볼거리	流行性耳下腺炎,おたふく風邪
농사	農業
법률가	弁護士
바다표범의 일종	水兵,船員,ジャック,水夫
누나	姉,お姉さん,姉貴
노선	路線,道順,通路,道筋,軌道,みちじゅん
보고타	ボゴタ
노상	どうしょう
농부	農家
글자바꿈수수께끼	アナグラム
농민	農家
방어자	保護者,係員
노출	暴露
방안지	グラフ用紙
백악관	ホワイトハウス
녹청	緑青
중도주의	中道政治
눈멂	盲目
바이트	バイト
에틴알콜	エタノール
농즙	うみ,膿
지치지 않는	勤勉
조이스틱	ジョイスティック
널히	1. 優 2. 優
반작용	中和
보고자	ジャーナリスト,記者,リポーター,報告者
반입자	反粒子
논전	論争
젖먹이기	かんご
네팔	ネパール
그 색	マゼンタ,マジェンタ
논쟁	1. 論争 2. 論争
농업	1. 農業 2. 農業関連産業,農業,大規模農産業
농양	膿瘍
2가 원소	二和音
범률가	代言人,弁護士
네 발 가진	四足歩行,四足獣,四本脚
납치	誘拐
자기 제품	磁器,ポースレン,陶磁,焼き物,陶磁器
농도	密度
코넷 주자	トランペット,口琴
놓다	1. 置く 2. 実装する,導入,インストール,インストールする,導入する 3. 置く
농담	笑い
그 후	それ,それから,その後,後で
낙타	駱駝,ラクダ
노대	バルコニー
냉전	1. 米ソ冷戦 2. 冷戦
농노	農奴,小作人
낭창	紅斑性狼瘡
방어류	カンパチ,鰤
아부다비	アブダビ
네모	長方形,ちょうほうけい
양의 적리	スクレイピー
반의어	対義語,反対語,対語,反意語,反義語
난창	南昌
반음양	双成り
난징	南京
낙지	タコ,蛸
국회의사당	連邦議会議事堂
반음영	半影
미적 정서의 연구	美学,美學
짜기 시작한 우유	初乳
내전	内乱,内戦
내적	内積
창조자	創作者
농구	1. バスケ,バスケットボール 2. バスケットボール
남중	1. 遠地点 2. 正中
바이칼	バイカル
내장	1. 肝 2. もつ
내의	shitagi,したぎ,下着
내일	1. 未来 2. 明日 3. 明日
벽돌공	石工
노병	戦士,せんし
바탕부터의	根深い,nebukai,ねぶかい
난한	うざい,騒がしい,姦しい
냅킨	ナプキン
넓은	広い,広々とした,広々
내파	爆縮
박절기	メトロノーム
난혼	二股
난황	卵黄
네온	ネオン
내포	河口,川口
남한	韓國,韓国,大韓民国
놀란	びっくりする
동틀녘	akegata,暁,夜明け,あけがた,明け方
노루	ノロジカ,鹿
노름	kake
창조성	創造性,創造力
중도정치	中道政治
양 지키는 개	bokuyōken,ぼくようけん,牧羊犬
노래	1. 歌曲,歌 2. 民謡
노랑	黄色
노력	レスリング
작은 언덕	小山,丘
국가 사회주의	ファシズム,ナチ主義,国家社会主義,ナチズム
서조선만	西朝鮮湾
남방	シャツ,Ｔシャツ
남미	南米,南アメリカ
끊은	禁欲
봄같은	若々しい
낙서	1. rakugaki 2. 落書き
나사	ねじ
운이좋은	運のよい,幸運,運の良い,ラッキー
고쳐말하다	引用する,言い換える
나무	1. 木,樹木 2. 木材
보기 싫지 않은	美しい
농장 경영자	農家
나물	na,野菜
내란	内乱,内戦
나리	百合,ユリ,yuri
마르멜로	マルメロ
첨부물	接辞
낱말	1. 名誉の単語 2. 単語,語
나병	天刑病,癩病,ハンセン病
내륙	内陸
나복	1. ルタバガ,カブハボタン 2. ルタバガ,カブハボタン
나방	蛾,が
난민	難民
평가할수 있는	かちたかい,価値高い,kachitakai,貴重,大切な
사립 중등 학교	大學,学園,大学,学寮,単科大学
교묘하게 다루는	操作的
낙원	極楽,パラダイス,楽園,十万億土,rakuen,らくえん,天堂
내연의 처	情婦
핵 에너지	原子力
방울뱀	がらがら蛇,ガラガラヘビ
내시	宦官
냄새	1. 臭気,匂い,臭い 2. 臭気,匂い,香り
날씨	天気,気象,てんき
제 1인칭	一人称,最初人
공시 언어학	共時性
노궁	トレビュシェット
남옥	アクアマリン
논거	データ
난자	卵子
남색	こうもんせいこう,アナルセックス
기상 위성	きしょうえいせい,気象衛星
남성	1. 男性名詞,男性,男性的な,男の,男性の 2. 男性 3. 男性 4. 男性 5. 男性
교통순위우선	優先権
낚시	釣り針
난시	乱視
난소	卵巣
청바지	ジーンズ,ジーパン
제 2인칭	二人称,第2の人
나안	肉眼
수염수리	ヒゲワシ
밤자갈	合金,金属
버몬트	バーモント
크레틴병 환자	頓痴気,低能者,間抜け,baka
동물 질식시험기	消火器
완성하다	終わる
방언학	方言学
남극	南極,南極大陸
방위각	方位角
거대 분자	高分子
발자취	なごり,痕跡,足跡
난간	手すり
유서 깊은	祝われた
첼린저	挑戦者
나라	1. 国家,共和制,国 2. ちほう,ぐん,地,区,地方,gun,領土
알데히드	アルデヒド
그 꽃	サフラン
난로	ストーブ
내기	kake
케이블철도	鋼索鉄道
낚다	釣り
난닝	南寧
베레모	ベレー帽
버뮤다	バミューダ,バーミューダ
동토대	ツンドラ,凍原
쓰나미	津浪,津波,つなみ
복덕방	不動産屋
꿀벌	ミツバチ,蜜蜂
가죽 조끼	ウェストコート
이산화규소	ケイ素二酸化物
잉글랜드	イングランド,英國,えいこく
컵케이크	カップケーキ
파이중간자	パイ粒子
각본의 상연법	劇場
땅콩 버터	ピーナッツバター
드디어	tsui ni,終に,遂に,竟に,ついに
태즈메이니아	タスマニア
후쿠오카	福岡
꿇다	跪く
올빼미 새끼	ふくろう,梟,フクロウ
화산암 부스러기	スラグ,鉱滓
고통스럽게	痛い,いたい,苦しい
아둔패기	うすのろ,でくのぼう
대브리톤	連合王国,グレートブリテン島,ブリテン,英国,グレートブリテンおよび北アイルランド連合王国,イギリス
꽃잎	花弁,hana
발췌록	抜粋
국가 전체의	国立
모욕하다	侮辱する
소아마비	急性灰白髄炎
꽃병	花瓶
속물근성	唯物論
자진해서	進んで,快く
실업계의 거물	きょとう,巨頭,実力者
바카라	バカラ
기획	きぎょう,企業,kigyō
기회	1. チャンス 2. けいき,契機,keiki,チャンス 3. チャンス 4. チャンス
까페	1. 食堂 2. kafe,コーヒーハウス,珈琲,コーヒー店,喫茶店,カフェ
기후	気候
돌연한고장	欠陥
반드럽게 함	さらさら,さらさらと,つるつる
기품	きっぷ
젖 모양의 액체	ミルク,牛乳,乳
정기 지불금	強風
빙하시대	氷河期
꼬박	存分に,十分
깡패	悪党,悪漢,悪人
팔레스타인 지구	パレスチナ領土,パレスチナ
기초	きそ
기차	列車
로즈메리의 잎	ローズマリー
긴축	狭窄
고춧가루	カイエンペッパー
받침점	支点
극형	死罪,死刑,極刑
기타	など,等
참가하다	参加する,參加
받기 쉬운	脆い,脆弱な,傷つきやすい
급히	きゅうきょ
깃털	羽毛
금지	拒否権
직육면체	直方体
기압	気圧
기업	きぎょう,企業,kigyō
기억	1. kioku,記憶,きおく 2. 記憶 3. 記憶 4. 記憶
초심리학	超心理学
근처	周辺,近隣
기울	もつ,臓物
기원	嘆願
현재 시제	現在時制,現在形
규토	ケイ素二酸化物
돈호법	アポストロフ,アポストロフィー,省略符号
방첨탑	方尖柱,オベリスク
근친	いとこ,従兄弟,従姉妹
긴자	振り子
기절	シンコピー,失神
귀환	そうかん
실존주의	実存主義
차우멘	炒麺,チャオミェン
균학	菌類学
급수	都市インフラ
근심	不安,心配
금속	合金,金属
권태	もの憂さ,無聊,アンニュイ,つれづれ
귀지	耳屎,耳垢
금성	1. 宵の明星 2. 金星,ウェヌス 3. 金星,ウェヌス
귀청	鼓膜
국화	菊,kiku
극악	残虐行為
권투	拳闘,ボクシング
군함	kansen,軍艦,かんせん
급우	クラスメート,級友,同級生,クラスメイト
페닐알라닌	フェニルアラニン
권한	地平線
근일	アプス,長軸端
그저	決まって,かならず,renjitsuren'ya,連日連夜
천랑성	シリウス,天狼星
금언	スローガン,標語
극장	劇場
극의	風光明媚
궁핍	貧困,貧乏
도해자	イラストレーター
옹호운동	遠征,ジハード
기습	驚き
균차	不同,不平等
권화	けしん,化身,ごんげ,権化
공기에 쐬다	蒸発する
기술	科学技術,応用科学,生産技術,工学,テクノロジー,工業技術
귀신	ジン,精霊
교태	軟派
근방	近所,概算,近傍,近似量
길드	クラブ,社会
근면	丹念
마스터베이션	自慰,オナニー,マスターベーション,オナニ
그물	魚網
시안화 수소산	シアン化水素
궤양	潰瘍
국채	1. 公債 2. 国債
깁다	縫う
금방	さっき
폴리네시아	ポリネシア
규소	1. ケイ素二酸化物 2. ケイ素,珪素,シリコン
교파	秘密結社,カルト
구취	口臭
교토	近畿,きんき,祇王寺,Kinki,京都,化野,京都市
규산	ケイ素二酸化物
깎다	切る,刈る
걸터앉아	1. にまたがって,足を広げて 2. 足を広げて
권총	ピストル
기린	麒麟,ジラフ,キリン
규슈	九州
기록	記録
반칙자	罪人
교황	教皇,法王,ポープ,ローマ法王,ローマ教皇
민중 선동가	煽動
급사	ツアーコンダクター,宅配会社,メッセンジャー,旅行添乗員,つかい,運送会社
단골 손님	顧客
귀족	貴族
그룹	満員
귓불	みみたぶ,耳たぶ,耳朶
광학	光学
기니	ギニア
그릇	いれもの,iremono,入物,入れ物,コンテナ,容器
궁정	ハーレム
기단	気団
권운	1. 巻雲 2. 巻雲 3. 巻雲,すじ雲
그만	もう,これ以上,最早
좌담식의	口語の,口語,話し言葉
기담	逸話,秘史
외고집으로	それどころか
권장	推薦
금룡	イグアノドン
급료	サラリー,給料,きゅうりょう
군의	軍事的な
국제	国際的な
깔개	カーペット,絨毯
국적	国籍,こくせき
꼬드기다	動機を与える
개척상의	文化的,文化の,文化的な
그람	グラム
그래	絶対に
재치문답	謎,nazo
극락	極楽,パラダイス,楽園,十万億土,rakuen,らくえん,天堂
그램	グラム
딱한 사정	迷惑,厄介者
우타르프라데시	ウッタル・プラデーシュ
군주	1. ツァーリ,ツァール,ツァー 2. 独裁者
군중	1. 満員 2. 群衆
구월	くがつ,九月,9月,長月
공항	kūkō,空港,くうこう
설득하다	お世辞を言う,諂う
굴욕	汚辱,屈辱
교의	教義
국제 올림픽 대회	オリンピック,近代オリンピック,オリンピック競技大会
귀리	1. オートムギ 2. オートムギ
고발하는	批難,非難
기공	気孔
교정	編集
교접	性交
궁술	弓道
교전	会戦,ikusa,レスリング,戦い
고발하다	問う,弾劾する
근동	近東,中東,ちゅうとう,Chūtō
권세	優勢
기구	楽器,樂器,gakki
골프	ゴルフ
교조	教義
근데	やはり,しかも,それにもかかわらず,それでも
극동	極東
기근	1. 飢え,きが,うえ,飢餓 2. 飢饉,不足
펀자브어	1. パンジャーブ語 2. パンジャーブ語
장치하다	実装する,導入,インストール,インストールする,導入する
유동바퀴	怠け者
공포	1. 恐怖 2. 恐怖 3. 恐怖 4. 恐怖
고환	金玉,睾丸,精巣
그냥	只,単に
국수	ヌードル,麺類
계획	反省,黙想
궤변	詭弁
기간	時代
교육	1. 訓練 2. 躾,教育,子育て 3. 授業 4. 教授法,てじゅん,授業
균등	画一性,統一性,普遍性
골파	1. 長葱,白葱,ネギ 2. チャイブ
교외	近郊,郊外,地区
궁상	nyūyō,ひつよう,入用,にゅうよう
고통	1. 痛み,苦痛,itami 2. 拷問
금귤	キンカン,金柑
경험	経験
겸허	謙遜
금광	掘削,開削
바르비투르 산염	精神安定剤
자웅 혼주	多婚性
착유장	酪農場,牛乳屋,牛乳販売店,日用雑貨店,牧場
아주 작은 조각	原子,ほこり,粒子
광차	ライトレール,路面電車,トロリーバス
금기	禁忌
결함	不完全
결핵	結核
교수	教授
결핍	1. 貧困,貧乏 2. 飢饉,不足 3. けつ,不足
글자 맞추기	判じ物
구비	伝統,でんしょう,伝承,でんとう
공채	公債
교습	授業
교실	kyōshitsu,きょうしつ,教室
결혼	1. 結婚する 2. 結婚,夫婦 3. kon'in,結婚,婚姻,こんいん 4. 近親婚
관찰	観察,観覧
노 젓는 사람	射手,shashu,しゃしゅ
구별	差別
고추	1. 陰核,ペニス,ちんこ,ちんちん,陰茎,男根,ちんぽ,イチモツ 2. タバスコ 3. 唐辛子,パプリカ 4. 唐辛子,パプリカ
광자	光子
국민	国籍,こくせき
과즙	フルーツジュース,果汁
격하	陥落
구분	トリアージ
교사	教師
광저	広州,広州市
관절	1. 関節 2. 関節 3. 関節 4. 関節 5. 関節
귀납	再帰
균계	菌類,きのこ
군모	シャコー帽
공조	モア
과자	菓子,お菓子,御菓子
계층	階層
과점	寡占
나가사키	長崎
광업	掘削,開削
관장	浣腸
공주	ひめ,ōjo,姫,王女,hime,おうじょ,王妃
관여	参加
고집	忍耐,堅持
백일해	百日咳
공자	孔子,fūshi,孔夫子,夫子,ふうし
공장	こうじょう
구름	1. 雲 2. 雲
공적	達成,業績
구린	傲慢な,横柄な,高慢な
공제	引き算,減法
조질 식료	食物繊維,繊維
공원	公園
교미	性交
결코	必ず,zehi,正に,是非,その通り,屹度,実に,確かに,確実に,きっと,ぜひ
스와힐리 사람	スワヒリ語
공언	断言
견치	犬歯,けんし
경찰	警察
고저	不同,不平等
과산화물	過酸化物,過酸化水素水,過酸化水素
공안	警察
공알	クリトリス,陰核,雛尖,inkaku
굴뚝	煙突
고조	高潮
경첩	蝶番
공업	製造
괄시	軽蔑する,軽視する,あなどる
교리	教義
히로시마	広島
거품	泡,あわ,あぶく
교류	交流電流,交流
관심	関心
벨리즈	ベリーズ
고자	茶目
광속	鉛筆,えんぴつ
고인	死人
권능	教祖的指導力
뉴사우스웨일스 주	ニューサウスウェールズ
성문 폐쇄음	声門閉鎖音
과식	バガテル
일기 예보자	天気予報係
굽다	炙る
골양	虫歯,う食
관습	儀式
협잡 은행가	カーペットバッガー
계집	家内,fujin,妻,女子,つま,okusan,奥さん
차용어	借用語
괌섬	グアム
군도	群島
하박국서	ハバクク書
고아	孤児
과수	果樹
군대	軍隊
최저음 음전	バグパイプ
경종	警報
백조속	はくちょう座
공순	敬愛
공수	航空輸送,空輸
경제	経済学
혼인 재산 계약	婚前契約
공생	共生
광부	坑夫
공서	共生
가지고 놀기	軟派
구니	妄想
경쟁	ライバル
교또	近畿,きんき,祇王寺,Kinki,京都,化野,京都市
경위	先史時代
경유	ディーゼル燃料
괴뢰	偶人,操り人形,絡繰り人形,パペット
경이	驚き
결정	1. 結晶 2. 結晶
곱사	傴僂
방사선과	放射線医学
걸친	にまたがって,足を広げて
계약	条約
고수	1. コリアンダー 2. コリアンダー 3. コリアンダー
결점	不完全
경외	畏敬
고소	告発,容疑,告訴,ようぎ,言いがかり
타이베이	台北,タイペイ,タイベイ
겨자	マスタード
고색	緑青
고생	労働
거침	不同,不平等
과부	未亡人,後家
경악	1. 驚き 2. 驚き 3. 驚き
임시비용	成功報酬
겨우	ぎりぎり
겨울	冬,fuyu
공복	飢え,乾き,飢餓
공병	工兵,機関士,技術者,こうへい,エンジニア,技師
구기	ラクロス
격언	1. 成句,諺,ことわざ 2. 格言 3. 諺,ことわざ,格言 4. 諺,ことわざ,格言
공범	親友,友,shin'yū,しんゆう
공법	公法
구금	入牢,nyūgoku,nyūrō,入監,にゅうろう,nyūkan,にゅうかん,にゅうごく,入獄
과묵	無口
계속	連続的に
국경	1. 国境 2. 国境,極端 3. 国境,こっきょう 4. 国境,エッジ 5. 国境,エッジ 6. 国境
장려한 무덤	廟,霊廟
관리	行政,管理
고분	つか
구경	1. 口径 2. 直径
계사	連辞,指定詞,連結詞,コピュラ,繋合詞,繋辞
바느질하다	縫う
골반	骨盤
구개	上顎,口蓋
국가	国籍,こくせき
결심	思い切り
구각	架台,脚立
부탄 눌트럼	ニュルタム
거웃	陰毛,いんもう
괌도	グアム
광도	大きさ
교감	協心,コンセンサス,合意,総意
고름	画一性,統一性,普遍性
거위	鵝鳥,ガチョウ
곡류	穀物
계부	継父
고막	鼓膜
거의	実際に,殆ど,ほとんど
고모	おば,小母さん,おばさん
걱정	不安,心配
고명	名声,評判
검열	調査,点検
광둥	広州,広州市
걸작	名作,傑作
물건사기	買い物　
골목	うらどおり,うらとうり,裏通り
결손	不足
결석	欠席
공룡	恐竜
고발	告発,容疑,告訴,ようぎ,言いがかり
관례	伝統,でんとう
공리	常識
차점자	じてん,jiten
강풍	強風
경상	鏡像
경색	梗塞
고베	神戸市,,神戸
건지	ガーンジー島,ガーンジー
관료	官僚
반신반인	神人,超人
공매	競売,オークション
개체	個人主義
검색	剣士
벼르다	取り置く,配置する
거실	茶の間,ima,居間,いま,リビング
강치	海馬
경매	競売,オークション
경마	競馬
곁말	しゃれ,駄洒落,ダジャレ,語呂合わせ
공도	高速道路,公道,街道,公路,道
과당	フルクトース,果糖
갈탄	亜炭,褐炭
겁술	けんじゅつ
오줌싸다	小便をする,おしっこをする
계명	命令
검시	検死
광년	光年
마음 아픔	悲しみ
다산하는	肥沃な
계모	継母
감탄	しゃせい,感動詞,感嘆詞,間投詞
고로	高炉
간판	看板
격론	混乱
청록색	シアン
기다리는 사람	ウエーター,ウエイター
겨레	家族
관광	観光
값진	豪華な
겨를	暇,余暇,閑散,閑暇
정치 경제학	経済学
가축	1. 家畜,愛玩動物,ペット,かちく 2. 動物
개집	犬小屋
간체	杆体細胞,桿体細胞
가치	価値
광고	CM,広告
고니	白鳥,鵠
고두	叩頭
광기	精神異常
곪다	化膿する,ただれる,爛れる,化膿
건선	乾癬
고국	ぼこく,bokoku,ほんごく,母国,本国,hongoku,祖国
가족	家庭,世帯,家族
거물	きょとう,巨頭,実力者
고골	ゴーゴリ
가제	ガーゼ
간장	1. 大豆,だいず,ダイズ,daizu 2. 肝臓 3. 醤油,醬油,しょうゆ,shōyu 4. 肝臓
감염	感染,伝染
검룡	ステゴサウルス
감자	1. じゃがいも 2. 馬鈴薯
각주	マプト
건물	1. tatemono,建物,ビル,家 2. 建物,ビル
고기	1. 肉,果肉 2. 肉,解剖学,人体 3. 肉
강우	雨,降水,降水量
고급	上品
개업	就職
강점	得,やく,便宜,優位,有利
강제	強制,実施
경도	経度,經度
계단	1. かいだん,階段 2. かいだん,階段
개인	1. 個人,人 2. 人,人間
감정	感情
개울	おがわ
건반	キーボード
공격	1. 攻撃 2. 攻撃
계도	家系図
고난	患難時代
타임머신	タイムマシン
공군	空軍,airy
공구	道具,楽器
관개	灌漑
거북	1. 亀,カメ,かめ,陸亀 2. 亀,カメ
영화 1파운드	ポンド
거래	トランザクション
경기	トーナメント
간암	かんがん
개수	かいぜん
자산의 한 항목	資産
경구	格言
감실	聖骨箱
개선	かいぜん
미크롱	マイクロメートル
가을	秋,しゅうき,aki
깡충깡충 뛰놀다	浮かれ騒ぐ
거리	1. 距離 2. 距離 3. 距離
가위	はさみ,鋏
각위	サー,だんな
거름	肥料
간음	.婚外性交,姦通,不倫,姦淫,私通,密通
강압	威圧,強制
가재	ロブスター,イセエビ
가자	ガザ地区,ガザ
간유	肝油
개시	1. 始め 2. 就職
가운	ドレス,ワンピース
가요	民謡
집합시키다	1. 会する,集める 2. 集める 3. 集める 4. 集める
간염	肝炎
객실	茶の間,ima,居間,いま,リビング
가설	架空,小説
가성	ファルセット
각서	忘備録,メモ
각성	kakusei
걸다	賭ける
간성	双成り
필요조건	必要,nyūyō,入用,にゅうよう
건독	乾ドック
유기체의 일부로	有機
가사	企業,任務
머스켓 총	マスケット銃
간식	軽食,間食,スナック
갱부	坑夫
경골	keikotsu,けいこつ,脛骨
경관	keisatsukan,けいかん,警官,けいさつかん,keikan,警察官
강설	雪,天花,yuki,ゆき,玉塵
경고	警報
가수	1. 演奏家,演奏者,実行者 2. 歌手
천리안	透視
결과	1. 影響,結果 2. 結果 3. 結果 4. 返答,回答 5. 結果 6. 結果
게놈	ゲノム
도관제트	ラムジェットエンジン
결국	1. tsui ni,終に,遂に,竟に,ついに 2. やっと,ついに,結局,最終的に,とうとう
주기적인	周期的
되치기	背泳
가봉	ガボン
걷기	步行
가방	財布,ブリーフケース,鞄
각반	脚絆
가발	入れ毛,かつら
스웨덴의 수도	ストックホルム
개방	yunyūjiyūka,ゆにゅうじゆうか,輸入自由化
든든히	1. 中々,実質的に,なかなか 2. 実質的に
개미	蟻,アリ,ari
감법	マイナス,引き算,減法
갈보	1. 売春婦 2. 売春婦,すべた 3. 売春婦 4. 情婦 5. 売春婦 6. 売春婦,娼婦,パンスケ,ばいしゅん,させ子,売女,街娼
영속하는	不滅
정직하게	正直に
가만	静かに,安静に
가루	小麦粉,粉
가령	例えば,例,たとえば,tatoeba
가로	横の,横,水平な,水平
검객	剣士
뱀장어	ウナギ,鰻
드러내놓고	ぎりぎり
거기	そこ
가뭄	旱魃
참외류	メロン
개량	かいぜん
가명	1. 筆名,雅号,ペンネーム 2. あだ名,異名,偽名
갈망	1. 憧れ,akogare,あこがれ 2. 懇願,切望
갈마	カルマ
각막	角膜
갈륨	ガリウム
묵상	反省,黙想
무색	1. 無色 2. 無色
몰타	1. マルタ 2. マルタ島,マルタ共和国,マルタ
무소	犀,サイ
문서	令状
무술	武術,格闘技
목판	木版画
무식	無知,めくら,盲,不知
고대 그리스풍의	初期,古風な
문신	1. 文身,刺青,入れ墨,いれずみ 2. 文身,刺青,入れ墨,いれずみ
미가	ミカ書
목하	その内,実際に,今
이해할수 없는	説明できない
미골	尾骨
미관	もんしょう,紋章
적도 이북	ミクロネシア,ミクロネシア地域
미국	1. 亜米利加,アメリカ大陸,アメリカ州,アメリカ合衆国,アメリカ,米国 2. アメリカ合衆国,アメリカ
미궁	迷路,迷宮
보트니아 만	ボスニア湾
강약약격	ダクティル
설계하다	工兵,機関士,技術者,こうへい,エンジニア,技師
무예	武術,格闘技
문어	1. タコ,tako,蛸,たこ,章魚 2. タコ,蛸
묘지	墓地
아라비아 북동	クウェート
청년기	青年期,青春
무용	muda,むだ,無用,無駄
묶음	束,層
무인	戦士,せんし
반각	エヌ
무장	軍縮
문자	正書法,文字,文字綴り,オーソグラフィー,綴り,スペリング
무정	ijiwaru,いじわる,意地悪
남자용 야회복	燕尾服
묽은	水っぽい
문장	もんしょう,紋章
문전	文法書,文法,ぶんぽう
무좀	水虫
미남	アポロ,アポロン
묵주	ロザリオ
반구	hankū,hankyū,半球,はんきゅう,半球体
문제	1. 問題 2. 問題 3. 障害物 4. 問題
유료 도로	高速道路
역비례하여	互いに,tagaini,たがいに
책버팀	ブックエンド
믿다	頼る,あてにする
배관	運河,キセル,パイプ
방귀	屁,おなら
배경	前後関係,状況,文脈
믿는	堅い
방광	1. 膀胱 2. 膀胱
물집	水疱
밀도	密度
동족결혼	近親婚
배구	1. バレーボール 2. 排球,バレーボール
밀대	麺棒,:麺棒
동전력	電圧
반사율	アルベド
밉다	憎い
백금	プラチナ,ぷらちな,白金
캘리포늄	カリホルニウム
으리으리함	紋章学
박다	縫う
루이지애나 주	ルイジアナ州
반달	半月
배꼽	1. ネーブル,臍 2. へそ,臍
바다	大洋,外海,海洋,海
미래	未来
배낭	バックパック
반도	はんとう,半島
반대	論争
받다	1. 得る 2. える,得る,手に入れる,買う,成し遂げる 3. 得る
기량이 있는	科学的,科学的な
밀랍	蜜蝋
미로	迷路,迷宮
반둥	バンドン
타다남은것	石炭,種火
무슨 일이 있어도	1. ひょっと,tabun 2. 万一,ひょっと,tabun,多分,若しや,まんいち
큰소리로	1. 声を出して,大声で 2. 大声で
미리	予め,あらかじめ
뮤온	ミュー粒子
락토오스	乳糖,ラクトース
바륨	バリウム
발레	バレエ
바랑	財布,ブリーフケース,札入れ
물통	バケツ
바라	シンバル
코시컨트	コセカント
민물	淡水
경색형성	梗塞
반란	反乱,ほうき,hōki,暴動
불필요한	不用な,不必要
박명	1. 黄昏,薄明,日暮 2. 薄明
문학	1. 言語芸術,文芸,文学 2. 言語芸術,文芸,文学
배란	排卵
박모	黄昏,薄明,日暮
백랍	しろめ
창빈침	窓辺
민법	大陸法,民法
바리	つみに,tsumini,積荷
견실하게	1. しっかり 2. しっかり
발생지	出生地
벌금	喪失
바보	1. あんぽんたん,おたんちん,うすらとんかち 2. 馬鹿,バカ,あほ,ばか 3. 頓痴気,低能者,間抜け,baka 4. うすのろ,でくのぼう
클립보드	クリップボード,kurippubōdo
베개	枕,まくら
배려	丹念
발목	ashikubi,踝,足首,あしくび
필요하다	必要な
백로	1. 白鷺,鷺,サギ 2. 鷺
밀사	代表者
백모	おば,小母さん,おばさん
발상지	マッカ,メッカ
벌다	得る
다툼과불화의여신	エリス
찌무룩한	酸性の
배분	分配,割り当て
마이트너륨	マイトネリウム
벵골	ベンガル
미신	迷信
배반	裏切り
박식	博学,学
벌거숭이	裸体像
반신	神人,超人
미운	憎い
밀어닥침	ryūnyū,りゅうにゅう,流入
바순	ファゴット,バスーン
미어	米英語,アメリカ英語,米語
미얀마	ミャンマー,ビルマ
발상	観念,概念,構想
베냉	ベナン共和国,ベナン,ベニン
병기	軍備
흥미있는	おもしろい,面白い,omoshiroi
뮌헨	ミュンヘン
방식	方法,方式
믿음	信奉,信仰,宗教,しょしん,かくしん
미익	尻,ケツ
마술적인	マジック
밀월	蜜月,新婚旅行
연체동물학	軟体動物学
야생의 돼지	イノシシ,猪
베닌	ベナン共和国,ベナン,ベニン
베다	切る,刈る
미의	美的な
모독	冒涜
연방주의	連邦主義
명령	命令
몰다	かる
리튬	リチウム
모두	marude,全く,まるで,全て,丸で
메밀	蕎麦,ソバ
뒷거리	貧民窟,貧民街
리터	㍑,リットル
마취	麻酔
마카	マッカ,メッカ
모뎀	モデム,変復調装置
목란	モクレン
다이커리	ダイキリ
모래	浜,砂浜
메스	メス,円刃刀
목련	1. モクレン 2. モクレン
멘스	御猿,月事,月経
모루	金敷,アンビル,金床,鉄敷
모직 슬리퍼	スリッパ
매춘	淫売,売春,baishun,買春,切り売り主義
눈뜨게 하다	目を覚ます,起こす,目覚める,目ざめさせる,起きる
명명	あだ名,名前,固有名詞
명문	貴族
방사기	火炎放射器
모반	あざ,aza
명사	1. 名詞 2. 名詞 3. 名詞,名前
명상	反省,黙想
묘기	達成,業績
문간	ドア,戸,門,扉
모범	モデル
명성	1. 名声,評判 2. 有名,こうみょう,スター,名誉,大名,kōmyō 3. 名誉
마합	ムラサキ貝,イガイ,ムール貝
만풍	ペイガニズム
강압적인	強制的な
말함	発話
발생학	hasseigaku,taiseigaku,発生学,はっせいがく,胎生学,たいせいがく
먼저	旧来,かつて
물기	水圏
면역	予防接種
명언	名言
목성	木星
두려움	恐怖
두려운	やばい
목사	1. 说教者 2. 羊飼い 3. 牧師 4. 牧師,司祭 5. 司祭
수코양이	猫,雄猫
물가	浜,砂浜
물감	染料
물개	海馬
무도	踊り
묻다	質問する
모조 캐시미어	カシミア
미용실	美容所
물닭	オオバン
모아	モア
우크라니아어	ウクライナ語
무대	舞台,演壇
묶다	束,層
철도역	駅,駅(えき, eki),鉄道駅
메카	マッカ,メッカ
문답	会話
동의자	承諾,承服,しょうふく
모신	1. seinaru 2. seinaru
붉은 포도주	赤葡萄酒,赤ワイン
몰수	おうしゅう,押収,ōshū
미용사	1. 床屋,美容師 2. 床屋,美容師
몽상	空想
석기시대	旧石器時代
면제	免疫
목수	大工
메틸	メチル
동의어	類義語,同義語
목자	羊飼い
머핀	マフィン
멸치	片口鰯,アンチョビ
목젖	口蓋垂
터치스크린	タッチパネル
메탄	1. メタン 2. メタン
번득임	ぴかぴか
묘령	思春期,破瓜,青春期
모어	母国語,母語,bogo,ぼご
몰약	ミル
문득	突如,急に,突然,突然に
결점만 보는 사람	列聖調査審問検事,悪魔の代弁者,あまのじゃく
첸나이	チェンナイ,マドラス
목차	もくじ,mokuji,目次
동전기	電流
문명	1. 文明 2. 文明 3. 文明
동위체	同位体,同位元素
무명	匿名
무리	1. 満員 2. くみ,組,kumi
몽정	夢精,遺精
명칭	1. あだ名,名前,固有名詞 2. みょうじ,苗字,姓氏,あだ名,名字,姓 3. 仮名,あだ名,源氏名,かな,假名
베누스	1. 金星,ウェヌス 2. 金星,ウェヌス
물론	勿論,もちろん,当然
물레	糸車
시골 처녀	羊飼い
모터	1. モーター,エンジン 2. 原動機,発動機,機関,モーター,機械,エンジン
미온의	冷めた,ぬるい,なまぬるい
면허	1. ライセンス 2. ライセンス,允許
군비의 충실	こころがまえ
물병	ピッチャー
묘석	墓石
묘사	描写
평의원회	元老院
문법	文法書,文法,ぶんぽう
목축	牧草
모충	皮虫,毛虫,ワーム,芋虫,キャタピラ,無限軌道
마노	メノウ
만년	冬,fuyu
륙색	バックパック
열대의 구풍	ハリケーン,大暴風
막다	1. 窒息させる 2. まもる,守る 3. 予防,防ぐ
화산활동	火山活動
매년	1. 毎年 2. 年一回,毎年,年一回の
잉크 지우개	消しゴム
맹금	もうちょう,猛禽
마구	多量に
망간	マンガン
배반엽	胚盤葉
뤄양	洛陽
망고	マンゴー
만기	死ぬ,死
지붕없는 관람석	漂白剤
상륙작전의	水陸両用
촉매 작용	触媒作用
도처에	一般に
민속한	さっさと
마마	疱瘡,天然痘,痘瘡
의 구령	休戦,停戦
현상 경기회	懸賞付き競技
루피	ルピー
마멋	1. プレーリードッグ 2. マーモット
스타우트류	麦芽
말리	マリ
몹시 이상한	不可能
반달 사람의 기질	あらし
망막	網膜
마법	1. マジック 2. 黒魔術,呪術 3. サタニズム
참견하기 좋아하는	おせっかい
괴기 영화	スリラー
마디	段落
불가능하게하다	禁ずる,禁止する,禁じる
간선 도로	高速道路,公道,街道,公路,道
리마	リマ
매독	1. 梅毒 2. 淋病
망둑	ハゼ,鯊,沙魚
동시에일어나다	一致する
맥동	振戦
매듭	結び目
마술	1. 黒魔術,呪術 2. 魔術,魔法,呪術
동물 공포증	動物恐怖症,どうぶつきょうふしょう
베트남어	ベトナム語
천둥치는 폭풍우	らいう,雷雨
메달	メダル,勲章,賞牌
망상	キメラ,kimera
남아프리카	南部アフリカ,南アフリカ
종종걸음치는	小刻みな
맹렬	激烈
두바이	ドバイ
매매	お買得
먹다	食事する
얌전하게	綺麗に
베트남의	ベトナムの
민스크	ミンスク
매미	セミ,蝉
맘보	マンボ
벨기에	ベルギー
뱃멀미	船酔い
멍멍	ワン
멜론	1. メロン 2. メロン
몽골	1. モンゴル,蒙古 2. モンゴル
만조	高潮
목금	マリンバ,シロフォン,木琴
만주	満州国,満州
맥주	1. 麦芽 2. biiru,ビール,麦酒,bīru,ビール1杯 3. ビール,エール
만찬	昼食
매일	mainichi,まいにち
매장	葬式
맹약	条約
메모	忘備録,メモ
마오	毛沢東
리진	リシン
스위트피	suītopī,スイートピー
창세기	起源,創世期
멍듦	打撲傷
명금	鳴禽
마약	薬物,薬
머랭	メレンゲ
만자	卐,卍,ハーケンクロイツ
모국	ぼこく,bokoku,ほんごく,母国,本国,hongoku,祖国
참석자	じょせい,援助,助け,tasuke,たすけ,補助
말의	冗長な
맑은	愉快な,たのしい,愉快,tanoshii
맹세	せいやく
생명이 있는	必要な
마작	麻雀,マージャン
와트수;와트량	電力
머리	1. 頭 2. 頭 3. 頭蓋骨,頭骨,髑髏,骨 4. 頭
마을	1. 町,都市,街,村 2. 村 3. 質量 4. 町,村 5. 町,村
만월	満月
벚나무	sakura,さくら
기초를 이루는	基本
렌즈	1. レンズ 2. レンズ
레일	合金,金属
로봇	じんぞうにんげん,人造人間
벵골어	ベンガル語
랩톱	ノートパソコン
제 칠위의 천사	公国,権天使
로메	ロメ
개암나무	ヘーゼルナッツ,ハシバミ
로마	1. ローマ 2. ローマ
손 대지 않은	一切の
로잔	ローザンヌ
도마뱀 붙이	家守,守宮,ヤモリ
소멸하다	消える
루드	十字架像
철기 시대	鉄器時代
페니실린	ペニシリン
착실히	1. しっかり 2. しっかり
불행하게도	ainiku,残念,生憎
베르켈륨	バークリウム
로션	ローション,化粧水
작은 책자	小冊子
로킷	ロケット
최종주자	アンカーマン
루블	1. ルーブル 2. ルーブル
루비	1. ルビー 2. ルビー
독창력	創造性,創造力
뢰스	黄砂
우루과이	ウルグアイ
두묘액	リンパ液
책선반	本棚,書架,shoka,書棚
로즈	ロードス島
면허하다	認証する
만가	死者のためのミサ,鎮魂歌
네덜란드 사람	オランダ語,オランダ人,蘭語
서류 보관함	金庫
아인시타이늄	アインスタイニウム
유대인 집회	仮庵,幕屋,シナゴーグ
메노나이트	メノナイト
사용되지 않는	時代遅れ,廃れた,退化した
상상하다	想像する,そうぞうする
리겔	リゲル
루신	ロイシン
강변의 낮은 땅	河床
파슬리의 일종	チャービル
일정한 한결같은	統一された,一定の,画一な
째는사람	かわ,川
룩스	ルクス
작은 천칭	トレビュシェット
가시울타리	逆茂木
신성 모독	冒涜
코넷 음전	トランペット,口琴
작은 내	小川,流れ,入江,いりうみ,いりえ,入海,川,irie,iriumi
영 혼색 모직물	ギリュウモドキ
랍비	ラビ
레늄	レニウム
레닌	レーニン
라싸	ラサ
조제벤젠	ベンジン
동창생	クラスメート,級友,同級生,クラスメイト
라드	弧度,ラジアン
라듐	ラディウム,ラジウム
...신보	ツアーコンダクター,宅配会社,メッセンジャー,旅行添乗員,つかい,運送会社
인도네시아 공화국	インドネシア
미진동	振戦
북아일랜드의 수도	ベルファスト
인종 차별	1. 人種差別 2. 人種差別
융통성 있음	万芸,bangei,ばんげい
박애의	情け深い,慈善の,博愛の
라마	1. ラマ属 2. ラマ属
타이위안	太原
민족지	民族誌
작은 북	スネアドラム
럭비	ラグビー
경찰 기동대원	コサック
뜸함	小康
캄보디아	1. カンボジア,プノンペン 2. カンボディア,カンボジア
로듐	ロジウム
럭스	ルクス
란탄	ランタン
우편 번호	郵便番号
침략적인	積極的
래커	ラッカー
피할길 없는	必至の,恒常的,避けがたい,常習,避けることのできない,必至,不可避
반어의	皮肉な,風刺的な
네안데르탈인	ネアンデルタール人
작자 불명	匿名
비단옷을 입은	subesube,すべすべ
심황 뿌리	鬱金,ウコン
대단히 필요한	必要な
론강	ローヌ川
도처에 있는	普遍的
라자	ラージャー
반양자	反陽子
작은 만	小川,流れ,入江,いりうみ,いりえ,入海,川,irie,iriumi
몹시 싫어하다	嫌う,憎む,いやである
푸에르토리코	1. プエルトリコ 2. プエルトリコ
작은 배	ディンギー,手漕ぎ舟
레몬	1. レモン 2. レモン
제멋대로 하는	自分本位の,利己的な,わがままな,身勝手な,勝手な
확정되지 않은	曖昧
농담하는	剽軽,hyōkin）
터스커니	トスカーナ
나르키소스	suisen,水仙
배신자	背信者
가극의 흥행주	冒険家,企業家
초악티니드 계열	トランザクション
오버헤드 프로젝터	オーバーヘッドプロジェクタ
버리다	辞職する,辞任する,辞める,退位する
국제관리화	国際化
분규시키다	巻き込む
발열의	熱の（ある）
뒤늦은	遅い
라돈	ラドン,レイドン
랑군	ヤンゴン
버마어	ビルマ語
큰소리로 외치는	かまびすしい,喧しい
잠깐 동안의	はかない,hakanai,儚い,儚い (はかない)
큰소리로 외치다	叫ぶ
버릇없는 녀석	青二才
또한	-も,また,も,さらに,にも
얇은 막	太鼓,鼓,ドラム
떨림	振戦
들통	バケツ
태즈메니아 늑대	袋狼
똥개	雑種
피겨 스케이트	フィギュアスケート
남부 아프리카	南部アフリカ,南アフリカ
목을 달아매는 끈	首飾り,ネックレス
폴란드의 수도	ワルシャワ
안전하게	必ず,zehi,正に,是非,その通り,屹度,実に,確かに,確実に,きっと,ぜひ
처녀막	処女膜
바다생물	底生生物
딕시	minami
딤섬	点心
올림피아경기의	五輪
등유	灯油
땀샘	汗腺
등질	画一性,統一性,普遍性
처녀성	処女性
민영화	民営化
베니스	ヴェネツィア,ヴェニス
신교리의 채택	新語
때로	時々,時時,ときどき,たまに,tokidoki
바다사자	海馬
들음	聴診
타이프라이터	タイプライター,印字機
동의하다	承諾する,賛成する
탄자니아	タンザニア
뚜껑	蓋,ふた
미저골	尾骨
스핑크스 석상	スフィンクス
처녀임	処女性
선글라스	サングラス
... 하자 마자	その内,実際に,今
타지키스탄	タジキスタン,中央アジア
탄산가스	二酸化炭素
떡잎	双葉
시트르산	クエン酸
총검무장병	銃剣
무관심한	さりげない
땅콩	落花生,ラッカセイ
들깨속	シソ,山羊髭
예절 바른	丁寧な
뗏목	カタマラン
결정 요소	限定詞
등한	油断,過失,yudan,ゆだん
자택 감금	自宅軟禁
또는	...の代わりに,代わり
배설물	1. 大便,くそ,うんこ,ふん,糞便 2. べん,大便,baba,ばば,うんこ,ben,糞
창백한	青ざめた
도토리	ドングリ,団栗,どんぐり,donguri
미적분	微積分学
뒝벌	丸花蜂,円花蜂
듣다	聞く
정신적 지도자	牧師
도하	ドーハ
붉은 고기	赤肉
지루한 것	もの憂さ,無聊,アンニュイ,つれづれ
들다	費やす,掛かる
도표	グラフ
병기고	兵器庫
강간하다	襲う
뒤뜰	裏庭
등귀	きょうか
대뇌피질	大脳皮質
도토	カオリナイト
돼지	1. ブタ,豚 2. 豚
도쿄	帝都,とうきょう,Azabu,東京
픽토그램	ピクトグラム,象形
들개	ディンゴ
두부	tōfu,豆腐,味噌汁
티칼티칼	バーツ
동쪽	これ,東
벼락 출세자	出来星,成り上がり者,成り金
비단향꽃 무우	カーネーション
동지	友達,友人
불시에 습격하다	驚かせる
대추야자	ナツメヤシ
동족	血族
밀워키	ミルウォーキー
해안 지방	りんかい
동정	慈悲
카리브 해 제도	カリブ海
동의	1. 同意 2. 承諾,承服,しょうふく 3. 承諾,同意,しょうだく,しょうち 4. 同意
여성적인 남자	双成り
덤핑	投棄
동인	同胞
검열관의직	検閲
벽난로	囲炉裏,暖炉,だんろ,danro
말이 많은	冗長な
방수의	防水の
독일	1. 西ドイツ,ドイツ 2. doitsu,ドイツ,独逸
배수구	水管
잘못말하기	文盲
확률변수	確率変数
약식 야회복	タキシード
들소	1. アメリカ野牛,バイソン,野牛 2. バイソン,野牛 3. ヴィセント
뒤지	トイレットペーパー
허수아비	かかし
등불	電灯,灯
땜납	しろめ
뒤의	結果と
둔치	砂丘
뒤에	それ,それから,その後,後で
육지로 둘러싸인	内陸
방수포	タープ
딸기	1. ichigo,いちご,苺,イチゴ 2. 苺
들림	聞こえ
로마 제국	ローマ帝国
마찬가지로	-も,また,も,さらに,にも
살색의 양말	裸の,裸
큰너벅선	はしけ
배수법	水管
딩고	ディンゴ
두유	(豆乳
동해	Nihonkai,日本海
등대	とうだい,灯台
개양귀비	1. ポピー,ケシ色,ケシ,ヒナゲシ 2. ヒナゲシ
공동으로 일하다	(敵に) 協力する,共同して働く,協力する
보석류	akusesarī,ジュエリー,宝飾品,アクセサリー,装身具
통속적으로	いつもは,俗,通常,tada,何時も,一般に,日頃,大抵,普通に,ただ,いつも
할리우드	ハリウッド
데이터 마이닝	データマイニング
도수관	用水路
살랑살랑소리	こごえ,私語,小声
쾌락주의자	美食家,料理通,グルメ,食通
멋대로의	任意,不特定多数
시트론색	1. シトロン 2. シトロン
절지 동물	節足動物
항해일지	日誌,自動車登録台帳
일광욕을 하다	日光浴をする,日光浴
인조 꼭두서니	あかね,茜色,アカネ
셈어족의 사람	セム,セム族の人
약혼 반지	婚約指輪
다윗 왕	ダビデ
생일선물	誕生日プレゼント
도상학	図像学
유대인 학살	ポグロム
코발트 청색	コバルトブルー
천체론	天文学,天文,天文學
단정치 못함	油断,過失,yudan,ゆだん
약탈하다	1. 盗む 2. 荒らす
과소 평가	かしょうひょうか,過小評価
의지할 수 없는	心許ない
열대적인	回帰線,熱帯
마시맬로	ビロードアオイ,マシュマロ
어느 정도는	一部,部分的に
...이면	nagaraku,ながらく,長らく
주장하다	喧伝する,言い切る,断言する,確言する,主張する,強弁する,言い張る
불공평	不当,不當
임신하여	おもしろい,面白い,omoshiroi
끊임없이	1. いつも 2. 幾久しく,eikyūni,ikuhisashiku,永久,永久に,永遠 3. 連続的に 4. いつも 5. 絶え間なく,いつも
면치못할	必然の,避けがたい
첫쨩로	第一に,最初に
그에 알맞게	したがって
깊이 간직하다	埋め込む
우크라이나	ウクライナ
회교 교당	モスク
절단하다	切り離す,切断,切断する
첫째로	おもに,主に
편견을 품게 하는	害する,損なう
마시멜로	ビロードアオイ,マシュマロ
체조장	ジム,体育館
라틴아메리카	ラテンアメリカ
북극성	ポラリス,北極星
겉으로는	思しい,明らかに,明白に,らしい,明らか
청진기	聴診器
독수리	1. ワシ 2. ハゲタカ
돈세탁	資金洗浄,マネー・ローンダリング
임신하는	1. 母方の,母性 2. 母方の,母性,父方の,父性 3. 母方の,母性 4. 母方の,母性 5. 母方の,母性
불경죄	裏切り
백화점	デパート
돛새치	バショウカジキ
유명하다	祝われた
과두 독재국	寡頭制
진짜 그대로	勿論,もちろん,当然
동성애	同性愛,dōseiaisha,dōseiai,性的指向,どうせいあい
잔지바르	ザンジバル,ザンジバル島
북극대	北極
싸게 어림하다	過小評価する
배혈증	はっけつびょう,白血病
불가피	nyūyō,ひつよう,入用,にゅうよう
이하선염	流行性耳下腺炎,おたふく風邪
유대성소	仮庵,幕屋,シナゴーグ
출납관	会計係
상속하다	継承する,受継ぐ
두 나라 말로 쓴	バイリンガル,バイリンガルな,二ヶ国語併用の,二カ国語,二か国語の,二ヶ国語の
Palli	さっさと
이인종의 융합	統合,合併
치과 의숙	歯科学
용의주도함	慎重
변압기	変流器,トランスフォーマー,変圧器
뢴트게늄	ウンウンウニウム,レントゲニウム
북극곰	白熊,北極グマ,ホッキョクグマ
북극광	北光
흑표범	パンター,ヒョウ
...에 가까운	ben na,べんな,便な
불고기	ステーキ
초서체	草書
백혈병	はっけつびょう,白血病
평가하다	1. 計算する 2. 予見,計算する,予想
힘차게	強制的に
비웃음의	かたはらいたい,馬鹿らしい,kataharaitai,片腹痛い,馬鹿な
잔디 깍는 기계	草刈り,芝刈り機
알바니아어	1. アルバニア語 2. アルバニア語
회교 기원	イスラム教紀元,ヘジラ,逃避行
독신자	宦官
도시인	人民,市民,国民,公民,民衆,臣民,民
멜라네시아	メラネシア
1년간의	毎年,毎年の
범죄학	犯罪学
방화선	ファイアウォール
힘의단위	ダイン
백혈구	白血球
코펜하겐	コペンハーゲン
베이컨	ベーコン
앤티가 바부다	アンティグア・バーブーダ
돌고래의 일종	ハンドウイルカ
작은 호수	凹溜まり
베이징	北京,ペキン
방화문	防火扉
돌격소총	アサルトライフル
교정 수단	解毒剤
불가 사리	hitode,ひとで,ヒトデ,人手
범죄자	1. 罪人,犯人 2. 罪人
...않는	稀に
말이 없는	口堅い,口が堅い
생리 현상	生理学
방화대	ファイアウォール
가락이 맞는	なごやか
국무총리	首相,さいしょう
방향유	精油
빈약하게 하는 것	オートクレーブ
쌍둥이자리	ふたご座
관능에 호소하는	官能的な,肉感的な,豊満な
쿠 클럭스 클랜	クー・クラックス・クラン
'레'음	レ,ニ
카스트라토	カストラート
실지렁이	蚯蚓,ミミズ
베네치아	ヴェネツィア,ヴェニス
편중주의	認証
조원업자	庭師
장의일부	糞袋,腸,大腸,ちょう,腸管,糞嚢
공식서한	手紙
낙천주의의	楽観的な
천천히	のそのそ,そろそろ
후원하다	スポンサー
보안관	保安官
조선 민주주의 인민 공화국	北朝鮮,朝鮮民主主義人民共和国
철조망	逆茂木
자양분이있는	栄養素
아주나쁜	akumyōdakai,あくみょうだかい,悪名高い
천주료	カトリシズム
총애 받는 사람	子分
부동산	不動産
털 없는	パイパン
허가하지 않다	禁ずる,禁止する,禁じる
얼굴 표정	人相,ninsō,にんそう,顔
팔 집	不動産
핀란드의 시가	ルーン文字
위험한 고비	境目,不景気
인구 통계학	人口学,人口統計学
부도체	誘電体
청우계	晴雨計,気圧計
3행 광고	求人広告
자격을 박탈하다	無効にする,無力化する
숙련이필요치않은	下手な
내용 충실	妊娠,にんしん
부도덕	aku,あく
코방귀 뀌는	傲慢な,横柄な,高慢な
이디오피아 자리	アンドロメダ座
동시성	共時性
아카데미회원	アカデミー会員
아르고나우타이	アルゴナウタイ
염동 작용	観念動力,サイコキネスシス,念力,念動力,テレキネシス
몬테네그로	モンテネグロ
체온계	温度計
초기 단계	子供時代
보통 명사	普通名詞
분명치 않은	kasumi
동시에	同時に,一斉に
농업경영	農学
가자 지구	ガザ地区,ガザ
싸울아비	戦士,せんし
분출하다	げっぷ,噫気する,げっぷする,うっぷ,うっぷする,おくび,噫気,おくびする
알고리즘	アルゴリズム,arugorizumu
밤일하는 사람	夜更かし,宵っ張り,宵っぱり
독일국	doitsu,ドイツ,独逸
힘으로	強制的に
보스턴	ボストン
변화없이	決まって,かならず,renjitsuren'ya,連日連夜
권품천신	公国,権天使
안젤리카	シシウド,アンゼリカ
웨딩드레스	ウェディングドレス,ウエディングドレス
물결이 일고 있는	ウエーブのかかった,くねくねした
스테레오	ステレオ
툴툴거리는	短気な
봉사자	家来
자궁 내막염	子宮内膜炎
가니메데이성	ガニメデ
이동 기중기	ゴリアテ
쿠페형 자동차	クーペ
생각하다	1. 推定する,当たり前のことと思う 2. 考える 3. 想像する,推測する,そうぞうする,想像 4. 想像する,そうぞうする
애칭 창작	愛称
양측이 있는	相互的な,双方
독일의	ドイツ語,ドイツ
총명한	明敏
우주 왕복선	スペースシャトル
협력 거부자	愛国者
주홍색의	朱色,赤い
디스프로슘	ジスプロシウム
아프가니스탄	アフガニスタン
운동가 같은	強壮な
독일어	1. ドイツ人,独語,ドイツ語 2. イディッシュ語 3. ドイツ人,独語,ドイツ語,ドイツ
버클륨	バークリウム
끊임없는	1. 連続的に 2. いつも
뾰족뒤쥐	とがりねずみ
...줄곧	nagaraku,ながらく,長らく
청중석	講堂
모택동주의	毛沢東思想
선택하다	選ぶ,えらぶ
웨스트벵골	西ベンガル,西ベンガル州
독점물	専売,独占
병원체	病原体
기니비사우	ギニアビサウ
복수형	複数形,複数
나이로비	ナイロビ
운동 선수	jokkusutorappu,ジョックストラップ
떡갈나무	オーク材
고대 노르드어	古ノルド語
마멋의 무리	プレーリードッグ
돌연한	突如な,突然
책망하는 듯한	批難,非難
빠져나갈 구멍	抜け道
적도 기니	赤道ギニア
숭배 받는 것	áidoru
혁명선언	檄文,檄
원심 분리기	分離器
중편소설	短編小説
여자 수영 선수	人魚,ningyo,にんぎょ
성내지 않다	シャツ,Ｔシャツ
도장방	ハーレム
횡단 보도	1. 横断歩道 2. 横断歩道
무척 좋아하다	よせる
안개 짙은	kasumi
슬로베니아어	1. スロベニア語 2. スロベニア語
매니큐어 액	ネールポリッシュ
복소수	虚数,複素数
선양 시	瀋陽,瀋陽市
동화하다	toru,同化吸収する
어른거리는	明るい,あかるい,明い,akarui
오렌지 빛의	オレンジ色
무거운 짐을 덜다	降ろす
자기 본위로	かってに,katte ni,勝手に
동역학	原動力,動力学
안과의사	眼科学
병원균	病原体
운동 실조	運動失調
변절자	背信者
가이아나	ガイアナ,仏領ギアナ
체재객	hōkyaku,kyakujin,訪客,きゃくじん,客人
다닥냉이속	コショウソウ
독점자	専売,独占
사마리아 사람	サマリア語
도전자	挑戦者
뒤셀도르프	デュッセルドルフ
죄가 있는	有罪い
동위원소	同位体,同位元素
도전율	熱伝導,伝導度
별자리	星座
자기 본위의	自分本位の,利己的な,わがままな,身勝手な,勝手な
청정기	デバッガ
신성을더럽히는	mottainai,もったいない
반투명의	半透明な,澄んだ
보수계	manpokei,まんぽけい,万歩計
구두쇠의	勘定高い,かんじょうだかい,kanjōdakai
불경스러운	mottainai,もったいない
수양상의	文化的,文化の,文化的な
깨끗이 함	じょうか,掃除
체육관	ジム,体育館
온건주의	中道政治
노인의학	老人学,老人医学
상세하게	近く
로봇공학	ロボット工学
소화 기관	消化器
활동 범위	ぶどう園,ブドウ園
도르래	滑車
최고점	遠地点
교황 정치	司教の職
바로 그렇습니다	きっかり
브레일식 점자	ブライユ点字
길가메시	ギルガメッシュ
사무엘서	サムエル記
익살스러운 말	しゃれ,駄洒落,ダジャレ,語呂合わせ
아이스하키	アイスホッケー,ホッケー
대퇴골	大腿骨
실재 하지 않은	人工的な,人工の,人為的な
체세포	体細胞
불후의 명성	永生,永世
주혈 원충병	トキソプラズマ症
양심의 가책	良心の呵責,改寤,悔悟
유효하게	1. 有効に 2. 有効に
도마뱀	蜥蜴,トカゲ
열광케 하다	恐怖
폐가되는	1. 不便な 2. 不便な
프로그램의 작성	プログラミング,番組
~에 약을넣다	薬物,薬
바티칸	バチカン市国,法王庁,バチカン
부활하다	1. 起こす 2. 蘇らせる
밴쿠버	バンクーバー
더욱이	その上,しかも,その上に,尚且つ,さらに,katsu
신 화	神話
고무 지우개	消しゴム
치즈버거	チーズバーガー
사회주의	社会主義
1년에 한 번씩	1. 毎年 2. 年一回,毎年,年一回の
독립절	主文
아르헨티나	アルゼンチン
청새치	カジキ
유대인의	ユダヤ,ユダヤ人
불가사의한	マジック
아보카도	1. アボカド 2. アボカド
소희가극	オペレッタ,喜歌劇,軽歌劇
타락하다	堕落する
이산화 탄소	二酸化炭素
완수하다	達成する,収める,成し遂げる
돌리다	そむける
고등학교	高等学校,高校
하류의강 아랫녘의	川下
테네시 주	1. テネシー州 2. テネシー,テネシー州
징기스칸	チンギス・カン
어물쩍거리다	嘘をつく
면할수 없는	必然の,避けがたい
독립심	どくりつ,独立
의 철자를 틀리다	つづりを間違う
용어 해설	用語集
버들박하	綿棒
각구	砂時計
털이 많은	毛深い
가계	家系図
강건	堅牢
같게	似ている,同じような
가금	家禽
가극	オペラ,歌劇団
각기	脚気
오렌지 주스	オレンジジュース
롤러코스터	ローラーコースター
끈적이는	粘性
주류 소매점	酒店
드레스덴	ドレスデン
독일 마르크	ドイツマルク
강당	講堂
감동	感情
차마시는 시간	珈琲
가라앉다	1. 沈める 2. 沈む
타이페이	台北,タイペイ,タイベイ
개념	観念,概念,構想
가득	存分に,十分
강등	陥落
...을배설하다	排泄する
밀리세컨드	ミリ秒
강둑	川沿い,川岸,川端
같다	統一された,一定の,画一な
갈등	懸賞付き競技
왕후와 같은	誇り高い,hokoritakai,ほこりたかい
다항식	多項式
가나	ガーナ,ゴールドコースト
가난	貧困,貧乏
가끔	時々,時時,ときどき,たまに,tokidoki
감기	流行性感冒,ryūkōseikanbō,りゅうこうせいかんぼう,infuruenza,インフルエンザ
갈다	1. 耕す 2. 耕す
달필가	書家,書道家
가대	架台,脚立
병리학	病理学
타이타늄	チタン,チタニウム
사람이 살지 않은	むじんな,mujin'na,無人な
천왕성	1. 天王星 2. 天王星
수원으로 향하여	川上
신고하다	通告,知らせる
남태평양의 소왕국	トンガ
절대적인	絶対の
도이치란트	doitsu,ドイツ,独逸
장식이 없는	裸の,裸
말로 나타내다	発話
방사성 동위원소	放射性同位体
바텐더	ウエーター
주저하게	いじいじ
천의뜻	キロ,キログラム
주저하다	躊躇する,ためらう
수원으로 향하는	川上
유스호스텔	ホステル,ユースホステル
테살로니키	テッサロニキ
필드하키	ホッケー
보통 서법	草書
동력학	原動力,動力学
대패배	じょうか,掃除
가을 진드기	ツツガムシ
나이오븀	ニオブ
나자식물	裸子植物
최근의	最近,新しい
계속해서일어나다	続く
시대에 뒤진	旧弊,昔風,旧弊な
빨간 인조물감	あかね,茜色,アカネ
기분이 나쁜	病気
예상외로	1. ふと,無意識的に 2. ふと
가라오케	カラオケ
독물학	毒物学,物学
요리용 레인지	ストーブ
백러시아	ベロルシア,ベラルーシ
아첨하는 사람	おべっか使い
저버리다	放棄する,見捨てる
고민하다	気をそらす
바퀴통	ハブ
작은개자리	こいぬ座
웹 사이트	ウェブサイト
사제 엽서	葉書,hagaki,はがき
지르코늄	ジルコニウム
체신성	ゆうびんきょく,yūbinkyoku
자동 판매기	自動販売機
쓰레기통	ごみ箱
안개가 자욱한	kasumi
두개골	1. 頭蓋骨,頭骨,髑髏,骨 2. 頭蓋骨
통행료를 받는 문	高速道路
보드카	ウォッカ,ヴォートカ
평화주의자	平和主義者
길들인 동물	家畜,愛玩動物,ペット,かちく
운 좋은	幸運な,成功した,成功裏の
천연두	1. 疱瘡,天然痘,痘瘡 2. 天然痘
단호히	必ず,確かに,きっと
소형 정찰기	バッタ,きりぎりす
아주머니	おば,小母さん,おばさん
벌주다	ばっする
고추 가루	タバスコ
실업자를 위한	失業者,しつぎょうしゃ
그만하게	いつもは,俗,通常,tada,何時も,一般に,日頃,大抵,普通に,ただ,いつも
리가 만	リガ
대폭풍	サイクロン
기계번역	機械翻訳
모터싸이클	バイク,単車,オートバイ
동명사	動名詞
천산갑	センザンコウ
말이 적은	口堅い,口が堅い
로마 황제	テトスへの手紙
라트비아	ラトヴィア,ラトビア
우산이끼	苔植物門
열이동 펌프	ヒートポンプ
아나톨리아	しょうアジア,小アジア
가락지빵	ドーナツ
추진하다	1. 動機を与える 2. かる
보받이	雛形
돋보기	虫眼鏡,拡大鏡
잔존하다	ある,いる
담황색	シトロン
수염뿌리	繊維
용서하다	1. 許す 2. 許す
실험식	実証的
실험실	実験室,研究室
데이지	ヒナギク
안과 의사	眼科医
넘쳐 흐르는	あふれる
맨체스터	1. マンチェスター 2. マンチェスター
카리알라어	カレリア語
죄악의 온상	温室
식균작용	食作用
방해물	1. 障害物 2. 障害物
베이글	ベーゲル
하프시코드	チェンバロ
대학살	1. 大虐殺 2. 大虐殺 3. 修羅,虐殺,大虐殺,大量虐殺,惨殺
데이터	データ
방해석	方解石
대학원	大学院
본보기	モデル
대합실	待合室
드라큘라	ドラキュラ,どらきゅら
사이가 틀어진	疎い
동종 동질;동차성	斉次性
악독한이름난	akumyōdakai,あくみょうだかい,悪名高い
까뽀베르데	カーボベルデ
싸구려 포도주	wain,ワイン,葡萄酒
식용개구리	ウシガエル,牛蛙
대화극	会話
동물원	動物園
불연속의	慎重
자궁외임신	子宮外妊娠
동반구	旧世界
노인병학	老人学,老人医学
원격 조작	遠隔操作,リモートコントロール
신호의 횃불	かがり火
흡혈귀	吸血鬼,ヴァンパイア,ラミアー
나체꾸밈없음	裸体像
밑에 있는	基本
변색한	巧妙な,狡い,ずるい,狡猾,悪賢い
뉴햄프셔	ニューヘンプシャー
수학 선생	数学,數學
비겁한 사람	腰抜け,臆病者
발행소	発行人,出版社
찬찬히	故意,故意に,わざと,意識的な,態と
5각의 별표	ごかっけい
동물학	動物学
대감독대주교	大主教
맨 섬	マン島,ヒト
계속할 수 있는	1. 再生可能な 2. 再生可能な
두리언의 열매	ドリアン
디옥시리보 핵산	デオキシリボ核酸
만 모양의것	wan'nyū,わんにゅう,湾入
돌비늘	雲母
북아프리카	北アフリカ
알레르기의	1. アレルギー性の 2. アレルギー性の
대화재	火災,大火,火,大火災
우선배급	優先権
바하마	バハマ
실재하지 않는 것	現実離れ
틴에이저	少年,ティーネージャー
피난 사다리	避難経路,火災非難設備,非常階段,非常口
...을 포위하다	包囲,攻城戦
패션 모델	モデル
아소르스 제도	アゾレス諸島
두껍다	太い
공리적인	便利な
복막염	腹膜炎
지방 분리기	分離器
아인슈타인	アインシュタイン
쿠페형 마차	クーペ
수압 펌프	ポンプ
캐나다 남쪽의 주	オンタリオ湖
손으로 하는 일	手工芸
지나쳐 감	ハゼ,鯊,沙魚
마스카라	マスカラ
발표자	発行人,出版社
어린애 같은	幼稚
손해를 끼치는	害する,損なう
시험관	試験管
심판원	レフリー
신규모집	chōshū,ちょうしゅう,徴集
민족적 전통	人種差別
방파제	突堤,防波堤
박해자	圧制者
분격시키다	悪化する
희한한	esotica,エキゾチック
신하됨	しんじゅう
밤나무속	クリノキ
가족계획	家族計画
시에라리온	シエラレオネ
신표현	新語
볼로냐	ボローニャ
거짓말쟁이	嘘吐き,嘘つき
심포니	交響楽団,交響曲
모잠비크	モザンビーク
고압적인	強制的な
거짓말장이	嘘吐き,嘘つき
자그레브	ザグレブ
다시 세우다	建て直す,再建
공리주의	功利主義,実利主義
해석하다	明示する,説明する
번역자	1. 翻訳者 2. 翻訳者,通訳者
희한히	稀に
오세아니아, 대양주	オセアニア,大洋州
짙은 남빛	乾葡萄,干葡萄
흰꼬리수리	オジロワシ
냄새가 좋은	香ばしい,kōbashī,甘い香りのする,こうばしい
불구로 만들다	無効にする,無力化する
후방으로	1. 後方 2. 後方
구둣주걱	靴篦
여불비례	しっかり
호된시련	神明裁判
선광 부스러기	シャドーイング,シャドウイング
파슈토어	パシュトー語
도서관	1. 図書館 2. 図書館,ライブラリ 3. 図書館
떠들썩한	賑やかな
흰 후추	黒こしょう,白コショウ,白こしょう,白胡椒
재채기하다	しゃみをする,くしゃみをする
칠성장어	ヤツメウナギ
육안으로 보이는	1. 肉眼で見える 2. 肉眼で見える
도살장	屠場,食肉処理場
앙케이트	ankēto,アンケート
부베 섬	ブーベ島
활기를 띠어	生きている
